TraditionalName	LVName
-ezer	ˊezer
-gaber	geⱱer
-geber	geⱱer
-nego	nəgō
Aaron	Aʼarōn
Aaron	ʼAhₐron
Abaddon	Abaddōn
Abaddon	ʼAⱱaddōn
Abanah	ʼAⱱānāh
Abda	ˊAⱱdāʼ
Abdi	ˊAⱱdiy
Abdon	ˊAⱱdōn
Abed	ˊAⱱēd
Abed-nego	ˊAⱱēd-nəgō
Abednego	ˊAⱱēd-nəgō
Abel	Abel
Abel	Heⱱel
Abel	ʼAⱱēl
Abel	ʼĀⱱēl
Abel-maim	ʼAⱱēl-mayim
Abelmaim	ʼAⱱēl-mayim
Abi	ʼAⱱī
Abiathar	Abiathar
Abiathar	ʼEⱱyātār
Abida	ʼAⱱīdāˊ
Abiel	ʼAⱱīʼēl
Abiezer	ʼAⱱīˊezr
Abigail	ʼAⱱīgayil
Abihail	ʼAⱱīhayil
Abihu	ʼAⱱīhūʼ
Abijah	Abia
Abijah	ʼAⱱiyyāh
Abijah	ʼAⱱīāh
Abijam	ʼAⱱiyyām
Abilene	Abilaʸnaʸ
Abimael	ʼAⱱīmāʼēl
Abimelech	ʼAⱱīmelek
Abinadab	ʼAⱱīnādāⱱ
Abinoam	ʼAⱱīnnoˊam
Abiram	ʼAⱱīrām
Abishag	ʼAⱱīshag
Abishai	ʼAⱱshay
Abishai	ʼAⱱīshay
Abishua	ʼAⱱīshūˊa
Abishur	ʼAⱱīshūr
Abital	ʼAⱱīţal
Abitub	ʼAⱱīţūⱱ
Abiud	Abioud
Abiud	ʼAⱱīhūd
Abner	ʼAⱱnēr
Abraham	Abraʼam
Abraham	ʼAⱱrāhām
Abram	ʼAⱱrām
Absalom	ʼAⱱīshālōm
Abshai	ʼAⱱshay
Acco	ˊAkkō
Achaia	Aⱪaia
Achaicus	Aⱪaikos
Achan	ˊĀkān
Achar	ˊĀkār
Achaz	Aⱪaz
Achaz	ʼĀḩāz
Achbor	ˊAkbōr
Achim	Aⱪeim
Achim	Yōqīm
Achish	ʼAkīsh
Achmetha	ʼAḩmətāʼ
Achor	ˊĀkōr
Achsah	ˊAkşāh
Achzib	ʼAkzīⱱ
Acshaph	ʼAkshāf
Aczib	ʼAkzīⱱ
Adah	ˊĀdāh
Adaiah	ˊAdāyāh
Adam	Adam
Adam	ʼĀdām
Adar	ʼAddār
Adbeel	ʼAdbəʼēl
Addan	ʼAddān
Addar	ʼAddār
Addi	Addi
Addi	ˊAdī
Adiel	ˊAdīʼēl
Adin	ˊĀdīn
Adina	ˊAdīnāʼ
Adlai	ˊAdlay
Admah	ʼAdāmāh
Admin	Admin
Admin	Rām
Adna	ˊAdnāʼ
Adnah	ˊAdnāh
Adon	ʼAddōn
Adonijah	ʼAdoniyyāh
Adonikam	ʼAdonīqām
Adoniram	ʼAdonīrām
Adoraim	ʼAdōrayim
Adoram	ʼAdorām
Adrammelech	ʼAdrammelek
Adramyttium	Adramuttaʸnos
Adriatic	Adrias
Adriel	ˊAdrīʼēl
Adronicus	Andronikos
Adullam	ˊAdullām
Aenon	Ainōn
Agabus	Agabos
Agee	ʼĀgēʼ
Agrippa	Agrippas
Agur	ʼĀgūr
Ahab	ʼAḩʼāⱱ
Aharah	ʼAḩraḩ
Aharhel	ʼAḩarḩēl
Ahasbai	ʼAḩaşbay
Ahasuerus	ʼAḩashvērōsh
Ahava	ʼAhₐvāʼ
Ahaz	Aⱪaz
Ahaz	ʼĀḩāz
Ahaziah	ʼAḩazyāh
Ahban	ʼAḩⱱān
Aher	ʼAḩēr
Ahi	ʼAḩī
Ahiam	ʼAḩīʼām
Ahian	ʼAḩyān
Ahiezer	ʼAḩīˊezer
Ahihud	ʼAḩīḩud
Ahijah	ʼAḩiyyāh
Ahikam	ʼAḩīqām
Ahilud	ʼAḩīlūd
Ahimaaz	ʼAḩīmaˊaʦ
Ahiman	ʼAḩīman
Ahimelech	ʼAḩīmelek
Ahimoth	ʼAḩīmōt
Ahinadab	ʼAḩīnādāⱱ
Ahinoam	ʼAḩīnoˊam
Ahio	ʼAḩyō
Ahira	ʼAḩīraˊ
Ahishahar	ʼAḩīshāḩar
Ahishar	ʼAḩīshār
Ahithophel	ʼAḩītofel
Ahitub	ʼAḩīţūⱱ
Ahlab	ʼAḩlāⱱ
Ahlai	ʼAḩlay
Ahoah	ʼAḩōaḩ
Ahohite	ʼAḩōḩī
Ahumai	ʼAḩūmay
Ahuzzam	ʼAḩuzzām
Ahzai	ʼAḩzay
Ai	ˊAy
Aiah	ʼAyyāh
Aijalon	ʼAyyālōn
Ain	ˊAyin
Akeldamach	Akeldama
Akkub	ˊAqqūⱱ
Akzib	ʼAkzīⱱ
Alameth	ˊĀlemet
Alemeth	ˊĀlemet
Alexander	Alexandros
Alexandrian	Alexandria
Aliah	ˊAlvāh
Alian	ˊAlvān
Allemeth	ˊĀlemet
Allon	ʼAllōn
Almodad	ʼAlmōdād
Almon	ˊAlmōn
Alpheus	Alfaios
Alvah	ˊAlvāh
Alvan	ˊAlvān
Alyan	ˊAlvān
Amal	ˊĀmāl
Amalek	ˊAmālēq
Amanah	ʼAmānāh
Amariah	ʼAmaryāh
Amasa	ˊAmāsāʼ
Amashai	ˊAmashşay
Amashsai	ˊAmashşay
Amasiah	ˊAmaşyāh
Amaziah	ʼAmaʦyāh
Ami	ʼĀmī
Aminadab	Aminadab
Aminadab	ˊAmminādāⱱ
Amittai	ʼAmittay
Ammah	ʼAmmāh
Ammiel	ˊAmmiyʼēl
Ammihud	ˊAmmihūd
Ammihud	ˊAmmiyḩūr
Amminadab	ˊAmminādāⱱ
Ammishaddai	ˊAmmiyshadday
Ammizabad	ˊAmmizāⱱād
Ammon	ˊAmmōn
Ammonite	ˊAmmōnī
Ammonites	ˊAmmōnī
Amnon	ʼAmnōn
Amok	ˊĀmōq
Amon	ʼĀmōn
Amorite	ʼAmorī
Amorites	ʼAmorī
Amos	Amōs
Amos	ʼĀmōʦ
Amoz	ʼĀmōʦ
Amphipolis	Amfipolis
Ampliatus	Amplias
Amram	ˊAmrām
Amran	Ḩamrān
Amzi	ʼAmʦī
Anah	ˊAnāh
Anaiah	ˊAnāyāh
Anak	ˊĀnāq
Anakim	ˊAnāqī
Anakites	ˊAnāqī
Anam	ˊAnāmīm
Anamim	ˊAnāmīm
Anamites	ˊAnāmīm
Anammelech	ˊAnammelek
Anan	ˊĀnān
Anani	ˊAnānī
Ananiah	ˊAnanyāh
Ananias	Ananias
Anath	ˊAnāt
Anathoth	ˊAntotī
Anathoth	ˊAnātōt
Anathothite	ˊAntotī
Andrew	Andreas
Andronicus	Andronikos
Anem	ˊĀnēm
Aner	ˊĀnēr
Aniam	ʼAnīˊām
Anna	Hanna
Annas	Annas
Anthothijah	ˊAntotiyyāh
Antioch	Antioⱪeia
Antiochene	Antioⱪeia
Antipatris	Antipatris
Antothijah	ˊAntotiyyāh
Anub	ˊĀnūⱱ
Apelles	Apellaʸs
Aphek	ʼAfēq
Aphiah	ʼAfīaḩ
Apollonia	Apollōnia
Apollos	Apollōs
Apollyon	Apolluōn
Appaim	ʼAppayim
Apphia	Apfia
Appius	Appios
Aquila	Akulas
Ar	ˊĀr
Ara	ʼArāʼ
Arab	ˊArāⱱī
Arabah	ˊArāⱱāh
Arabia	Arabia
Arabia	ˊĒreⱱ
Arabian	ˊArāⱱī
Arabians	ˊArāⱱī
Arabs	Arabia
Arabs	ˊArāⱱī
Arad	ˊArād
Arah	ʼĀraḩ
Aram	Aram
Aram	Rām
Aram	ʼArām
Aramaic	ʼArāmīt
Aramean	ʼArammiy
Arameans	ʼArammiy
Arameans	ʼArām
Aran	ʼArān
Ararat	ʼArāraţ
Araunah	ʼAravnāh
Arba	ʼArbaˊ
Arbathite	ˊArⱱātī
Arbite	ʼArbiy
Archelaus	Arⱪelaos
Archippus	Arⱪippos
Archite	ʼArkī
Ardon	ʼArdōn
Areopagite	Areopagitaʸs
Aretas	Aretas
Argob	ʼArgoⱱ
Arieh	ʼAryēh
Ariel	ʼArīʼēl
Aries	Areios
Arimathea	Arimathaia
Arioch	ʼArəyōk
Aristarchus	Aristarⱪos
Aristobulus	Aristoboulos
Arkite	ˊArqī
Arkites	ˊArqī
Armageddon	Harmagedōn
Armageddon	Mount-Megiddon
Armoni	ʼArmonī
Arnan	ʼArnān
Arni	Arni
Arni	Rām
Arnon	ʼArnōn
Aroer	ˊArōˊēr
Arpachshad	ʼArpakshad
Arpad	ʼArpād
Arphaxad	Arfaxad
Arphaxad	ʼArpaksad
Arphaxad	ʼArpakshad
Arqi	ˊArqī
Artaxerxes	ʼArtaḩshashtāʼ
Artemas	Artemas
Artemis	Artemis
Arubboth	ʼArubōt
Aruboth	ʼArubōt
Arumah	ʼArūmāh
Arvad	ʼArvad
Arvadi	ʼArvādī
Arvadite	ʼArvādī
Arvadites	ʼArvādī
Aryok	ʼArəyōk
Arza	ʼArʦāh
Asa	ʼĀşāʼ
Asah	ˊAsāh
Asahel	ˊAsāhʼēl
Asaiah	ˊAsāyāh
Asaph	Asaf
Asaph	ʼĀşāf
Asarel	ʼAsarʼēl
Asarelah	ʼAsarʼēlāh
Asenath	ʼEşənat
Aser	Asaʸr
Aser	ʼĀshēr
Ashan	ˊĀshān
Asharelah	ʼAsarʼēlāh
Ashbea	ʼEshbēˊa
Ashbel	ʼAshbēl
Ashdod	ʼAshdōd
Asher	ʼĀshēr
Asherah	ʼAshērāh
Ashima	ʼAshimāʼ
Ashkelon	ʼAshqəlōn
Ashkenaz	ʼAshkənaz
Ashpenaz	ʼAshpənaz
Ashtaroth	ˊAshtārōt
Ashterathite	ˊAshtərātī
Ashtoreth	ˊAshtoret
Ashurites	ʼAshūrī
Ashvath	ˊAshvāt
Asia	Asia
Asians	Asia
Asiel	ˊAsiyʼēl
Asna	ʼAşnāh
Asnappar	ʼĀşənappar
Asriel	ʼAsrīʼēl
Asshur	ʼAshshūr
Asshur	ʼAshḩūr
Asshurim	ʼAshūrī
Assir	ʼAşşir
Assos	Assos
Assyria	ʼAshshūr
Asyncritus	Asugkritos
Atarah	ˊAţārāh
Ataroth	ˊAţārōt
Ater	ʼĀţēr
Athach	ˊAtāk
Athaiah	ˊAtāyāh
Athaliah	ˊAtalyāh
Athenians	Athaʸnai
Athens	Athaʸnai
Athlai	ˊAtlay
Atroth	ˊAţrōt
Attai	ˊAttay
Augustus	Augustus
Augustus	Σεβαστός
Avims	ˊAvviy
Avites	ˊAvviy
Avith	ˊAvīt
Avvah	ˊIvvāh
Avvim	ˊAvvim
Avvites	ˊAvvim
Azal	ʼĀʦal
Azaliah	ʼAʦalyāhū
Azaniah	ʼAzanyāh
Azareel	ˊAzarʼēl
Azarel	ˊAzarʼēl
Azariah	ˊAzaryāh
Azaryah	ˊAzaryāh
Azaz	ˊĀzāz
Azaziah	ˊAzazyāhū
Azbuk	ˊAzbūq
Azekah	ˊAzēqāh
Azel	ʼĀʦēl
Azgad	ˊAzgād
Aziel	ˊAzīʼēl
Aziza	ˊAzīzāʼ
Azmaveth	ˊAzmāvet
Azor	Azōr
Azor	ˊAzzūr
Azotus	Azōtos
Azotus	ʼAshdōd
Azriel	ˊAzrīʼēl
Azrikam	ˊAzrīqām
Azubah	ˊAzūⱱāh
Azzur	ˊAzzūr
Baal	Baal
Baal	Baˊal
Baal-perazim	Baˊal-pərāʦīm
Baalah	Baˊₐlāh
Baalat	Baˊₐlāt
Baalim	Baˊal
Baalpeor	Baˊal-pəˊōr
Baalperazim	Baˊal-pərāʦīm
Baals	Baˊal
Baana	Baˊₐnāʼ
Baanah	Baˊₐnāh
Baasha	Baˊshāʼ
Babel	Bāⱱel
Babylon	Babulōn
Babylon	Bāⱱel
Baharumite	Bḩₐrūmī
Bahurim	Baḩurīm
Bakbakkar	Baqbaqqar
Bakbuk	Baqbūq
Bakbukiah	Baqbuqyāh
Balaam	Balaʼam
Balaam	Bilˊām
Baladan	Balʼₐdān
Balah	Bālāh
Balak	Bālāq
Bamah	Bāmāh
Bani	Bānī
Barabbas	Barabbas
Barachias	Baraⱪias
Barachias	Berekyāh
Barak	Barak
Barak	Bārāq
Barhumite	Barḩumī
Bariah	Bārīaḩ
Barjesus	Bariaʸsous
Barkos	Barqōş
Barnabas	Barnabas
Barnea	Barnēˊa
Barsabbas	Barsabbas
Bartholomew	Bartholomaios
Bartimaeus	Bartimaios
Baruch	Bārūk
Barzillai	Barzillay
Basemath	Bāsəmat
Bashan	Bāshān
Bath	Bat
Bath-rabbim	Bat-rabim
Bathrabbim	Bat-rabim
Bathsheba	Bat-sheⱱaˊ
Bavai	Baūy
Bavvai	Baūy
Baz	Baz
Bazlith	Baʦlūt
Bazluth	Baʦlūt
Bealiah	Bəˊalyāh
Bealoth	Bəˊālōt
Bebai	Bēⱱay
Becher	Beker
Becorath	Bəkōrat
Bedad	Bədd
Bedan	Bədān
Bedeiah	Bēdəyāh
Beeliada	Bəˊelyādāˊ
Beelzeboul	Beʼelzeboul
Beer	Bəʼēr
Beer-	Bəʼēr
Beera	Bəʼērāʼ
Beerah	Bəʼērāh
Beeri	Bəʼērī
Beeroth	Bəʼērot
Beeroth	Bəʼērōt
Beeroth Bene-jaakan	Bəʼērot-bənēy-yaˊₐqan
Beersheba	Bəʼēr-sheⱱaˊ
Bela	Belaˊ
Beliar	Beliar
Belshazzar	Bēləshaʼʦʦr
Belteshazzar	Bēləţəshaʼʦʦar
Ben	Ben
Ben	Bēn
Ben-	Ben
Ben-hadad	Ben-hₐdad
Ben-hail	Ben-ḩayil
Benaiah	Bənāyāh
Bene-	Bənēy-
Benhadad	Ben-hₐdad
Benhail	Ben-ḩayil
Beninu	Bənīnū
Benjamin	Beniamin
Benjamin	Binyāmīn
Beno	Bənō
Beor	Bəˊōr
Beracah	Bərākāh
Berachah	Bərākāh
Beraiah	Bərāʼyāh
Berea	Beroia
Berean	Beroia
Berechiah	Berekyāh
Bered	Bered
Berekiah	Berekyāh
Beri	Bērī
Beriah	Bərīˊāah
Bernice	Bernikaʸ
Berothah	Bērōtāh
Berothai	Bērōtāh
Besai	Bēşay
Besodeiah	Bəşōdəyāh
Besor	Bəsōr
Betah	Beţḩ
Beth	Bēyt
Beth-aven	Bēyt-ʼāven
Beth-biri	Bēyt-birʼī
Beth-ezel	Bēyt-hāʼēʦel
Beth-haccerem	Bēyt-hkkerem
Beth-marcaboth	Bēyt-hmmrəkkāⱱōt
Beth-peor	Bēyt-pəˊōr
Beth-rapha	Bēyt-rāfāʼ
Beth-shean	Bēyt-shəʼān
Beth-shemesh	Bēyt-shemesh
Beth-zur	Bēyt-ʦūr
Bethany	Baʸthania
Bethbirei	Bēyt-birʼī
Bethel	Bēyt-ʼēl
Bethezel	Bēyt-hāʼēʦel
Bethhaccerem	Bēyt-hkkerem
Bethlehem	Baʸthleʼem
Bethlehem	Bēyt-leḩem
Bethmarcaboth	Bēyt-hmmrəkkāⱱōt
Bethpeor	Bēyt-pəˊōr
Bethphage	Baʸthfagaʸ
Bethrapha	Bēyt-rāfāʼ
Bethsaida	Baʸthsaida
Bethshean	Bēyt-shəʼān
Bethshemesh	Bēyt-shemesh
Bethuel	Bətūʼēl
Bethul	Bətūl
Bethzur	Bēyt-ʦūr
Betonim	Vbəţonīm
Bezai	Bēʦay
Bezalel	Bəʦalʼēl
Bezek	Bezeq
Bezer	Beʦer
Bichri	Bikrī
Bidkar	Bidqr
Bigvai	Bigvay
Bigvay	Bigvay
Bildad	Bildad
Bilgah	Bilgah
Bilgai	Bilgay
Bilhah	Bilhāh
Bilhan	Bilhān
Bilshan	Bilshān
Bimhal	Bimhāl
Binea	Binˊāʼ
Binnui	Binnūy
Birzaith	Birzōt
Birzavith	Birzōt
Bishlam	Bishlām
Bithiah	Bityāh
Bithynia	Bithunia
Blastus	Blastos
Boaz	Boʼoz
Boaz	Boˊaz
Bocheru	Bokrū
Bochim	Bokīm
Bohan	Bohn
Boscath	Bāʦəqat
Bosor	Bosor
Bosor	Bəˊōr
Bozez	Bōʦēʦ
Bozkath	Bāʦəqat
Bozrah	Bāʦərāh
Bukki	Buqqiy
Bukkiah	Buqqiyyāh
Bul	Būl
Bunah	Būnāh
Bunni	Bunniy
Buz	Būz
Buzi	Būzī
Cabul	Kāⱱūl
Caesar	Kaisar
Caesarea	Kaisareia
Caiaphas	Kaiafas
Cain	Kain
Cain	Qayin
Cainan	Kainan
Cainan	Qēynān
Calcol	Kalkol
Caleb	Kālēⱱ
Calneh	Kələneh
Cana	Kana
Canaan	Kinaˊan
Canaan	Ⱪanaʼan
Canaanite	Kananitaʸs
Canaanite	Kənaˊₐnī
Canaanites	Kənaˊₐnī
Candace	Kandakaʸ
Capernaum	Kafarnaʼoum
Caphtor	Kaftor
Caphtor	Kaftorī
Caphtorims	Kaftorī
Caphtorites	Kaftorī
Cappadocia	Kappadokia
Carchemish	Karkəməysh
Carites	Kārī
Carmel	Karmel
Carmelite	Karməlī
Carmi	Karmī
Carpus	Karpos
Casiphia	Kāşifyāʼ
Casluh	Kaşluḩīm
Casluhim	Kaşluḩīm
Casluhites	Kaşluḩīm
Celubai	Kəlūⱱay
Cenchrea	Kegⱪreai
Cephas	Kaʸfas
Chalcol	Kalkol
Chaldeans	Kasdiy
Chaldeans	Ⱪaldia
Charashim	Ḩₐrāshim
Chebar	Kəⱱār
Chelub	Kəlūⱱ
Chelubai	Kəlūⱱay
Cheluhi	Kəlūhayo
Chemosh	Kəmōsh
Chenaanah	Kənaˊₐnāh
Chenani	Kənānī
Chenaniah	Kənanyāh
Chephirah	Kəfīrāh
Cheran	Kərān
Cherethites	Kərētī
Cherith	Kərīt
Cherub	Kərūⱱ
Chesalon	Kəşālōn
Chidon	Kīdōn
Chileab	Kilʼāⱱ
Chilion	Kilyōn
Chilmad	Kilmād
Chimham	Kimhām
Chinnereth	Kinₐrōt
Chios	Ⱪios
Chislev	Kişlēv
Chittim	Kittim
Chloe	Ⱪloaʸ
Chorazin	Ⱪorazin
Chub	Kūⱱ
Cilicia	Kilikia
Clauda	Klaudaʸ
Claudia	Klaudia
Claudius	Klaudios
Clement	Klaʸmaʸs
Cleopas	Kleopas
Cnidus	Knidos
Col	Kāl
Col-hozeh	Kāl-ḩozeh
Colosse	Kolossai
Conaniah	Kōnanyāhū
Coresh	Kōresh
Corinth	Korinthos
Corinthians	Korinthios
Cornelius	Kornaʸlios
Cos	Kōs
Cosam	Kōsam
Cosam	Qāşam
Cozeba	Kozāⱱāʼ
Crescens	Kraʸskaʸs
Cretans	Kraʸtaʸ
Crete	Kraʸtaʸ
Crispus	Krispos
Cun	Kūn
Cush	Kūsh
Cushan	Kūshān
Cushi	Kūshiy
Cuth	Kūt
Cuthah	Kūt
Cyprian	Kupros
Cyprus	Kupros
Cyrene	Kuraʸnaʸ
Cyrenian	Kuraʸnaʸ
Cyrenians	Kuraʸnaʸ
Cyrenius	Kuraʸnios
Cyrus	Kōresh
Dabbesheth	Dabeshet
Daberath	Daⱱrat
Dagon	Dāgōn
Dalmanutha	Dalmanoutha
Dalmatia	Dalmatia
Damaris	Damaris
Damascene	Damaskos
Damascene	Dammeseq
Damascus	Damaskos
Damascus	Dammeseq
Dan	Dān
Daniel	Daniaʸl
Daniel	Dāniyyēʼl
Danites	Dānī
Dara	Dāraˊ
Darda	Dardaˊ
Darius	Dārəyāvesh
Darkon	Darqōn
Dathan	Dātān
David	Dawid
David	Dāvid
Debir	Dəⱱīr
Deborah	Dəbōrāh
Decapolis	Dekapolis
Dedan	Dədān
Delaiah	Dəlāyāh
Delilah	Dilīlāh
Demas	Daʸmas
Demetrius	Daʸmaʸtrios
Derbe	Derbaʸ
Derbean	Derbaʸ
Deuel	Dəˊūʼēl
Di-	Diy
Diblah	Dəⱱəlāh
Diblaim	Diⱱlayim
Dibon	Diyⱱōn
Didymus	Didumos
Didymus	[twin]
Diklah	Diqlāh
Dinah	Dīnāh
Dinhabah	Dinhāⱱāh
Dionysius	Dionusios
Diotrephes	Diotrefaʸs
Diphath	Rīfat
Dishan	Diyshān
Dishon	Diyshōn
Dizahab	Diy-zāhāⱱ
Dodai	Dōday
Dodanim	Dodānīm
Dodavahu	Dōdāvāhū
Dodo	Dōdō
Doeg	Doʼēg
Dor	Dōr
Dorcas	Dorkas
Dothan	Dotān
Drusilla	Drousilla
Dumah	Dūmāh
Dāniyyēʼl	Dāniyyʼēl
Ebal	ˊĒyⱱāl
Ebed	ˊEⱱed
Ebenezer	ʼEⱱen-hāˊēzer
Eber	Heber
Eber	ˊĒⱱēr
Ebiasaph	ʼEⱱyāşāf
Ecbatana	ʼAḩmətāʼ
Ecclesiastes	Qohelet
Eden	ˊĒden
Eder	ˊEder
Eder	ˊĒder
Edom	ʼEdom
Edom	ʼEdōm
Edrai	ʼEdreˊī
Edrei	ʼEdreˊī
Eglah	ˊEglāh
Eglaim	 ˊEglayim
Eglon	ˊEglōn
Egypt	Aiguptos
Egypt	Miʦrayim
Egyptian	Aiguptos
Egyptian	Miʦrayim
Egyptians	Aiguptos
Egyptians	Miʦrayim
Ehud	ʼĒhūd
Eker	ˊĒqer
Ekron	ˊEqrōn
El	ʼĒl
Ela	ʼĒlāh
Elah	ʼĒlāh
Elam	ˊĒylām
Elamites	Elam
Elasah	ʼElˊāsāh
Elath	ʼĒylōt
Eldaah	ʼEldāˊāh
Elead	ʼElˊād
Eleadah	ʼElˊādāh
Eleasah	ʼElˊāsāh
Eleazar	Eleazar
Eleazar	ʼElˊāzār
Elhanan	ʼElḩānān
Eli	Aʸli
Eli	ˊĒlī
Eliab	ʼElīʼāⱱ
Eliada	ʼElyādāˊ
Eliahba	ʼElyaḩbāʼ
Eliakim	Eliakeim
Eliakim	ʼElyāqīm
Eliam	ʼElīˊām
Eliasaph	ʼElyāşāf
Eliashib	ʼElyāshiyⱱ
Eliathah	ʼElīʼātāh
Eliehoenai	ʼElyəhōˊēynay
Eliel	ʼElīʼēl
Elienai	ʼElīˊēynay
Eliezer	Eliezer
Eliezer	ʼElīˊezer
Elihoenai	ʼElyəhōˊēynay
Elihoreph	ʼElīḩoref
Elihu	ʼElīhū
Elijah	Aʸlias
Elijah	ʼĒliyyāh
Elika	ʼElīqāʼ
Elim	ʼĒylim
Elimelech	ʼElīmelek
Elioenai	ʼElyəhōˊēynay
Eliphal	ʼElīfāl
Eliphalet	ʼElīfeleţ
Eliphaz	ʼElīfaz
Elipheleh	ʼElīfəlēhū
Eliphelehu	ʼElīfəlēhū
Eliphelet	ʼElīfeleţ
Elisha	Elissaios
Elisha	ʼElīshāˊ
Elishaphat	ʼElīshāfāţ
Elisheba	ʼElīsheⱱaˊ
Elishua	ʼElīshūˊa
Eliud	Elioud
Eliud	ʼĒl-hōd
Elizabeth	Elisabet
Elizaphan	ʼElīʦāfān
Elizur	ʼElīʦūr
Elkanah	ʼElqānāh
Elkoshite	ʼElqshiy
Elmadam	Elmōdam
Elmadam	ʼAlmōdād
Elnaam	ʼElnaˊam
Elnathan	ʼElnātān
Elohim	ʼElohīm
Elon	ʼĒylōn
Eloth	ʼĒylōt
Elpaal	ʼElpaˊal
Elpalet	ʼElīfeleţ
Elpelet	ʼElīfeleţ
Eltekon	ʼEltəqōn
Eltolad	ʼEltōlad
Elul	ʼElūl
Eluzai	ʼElˊūzay
Elymas	Elumas
Elzabad	ʼElzāⱱād
Elzaphan	ʼElīʦāfān
Emim	ʼĒymīm
Emite	ʼĒymīm
Emites	ʼĒymīm
Emmanuel	Emmanouaʸl
Emmanuel	ˊImmānūʼēl
Emmaus	Emmaous
Emmor	Emmor
Emmor	Ḩₐmōr
Emori	ʼAmorī
En	 ˊĒyn
En-eglaim	 ˊĒyn-ˊeglayim
En-gedi	 ˊĒyn-gedī
En-rimmon	 ˊĒyn-rimmōn
Enan	 ˊĒynān
Enan	 ˊĒynōn
Enan	ˊĒynān
Eneas	Aineas
Eneglaim	 ˊĒyn-ˊeglayim
Engedi	 ˊĒyn-gedī
Enoch	Enōⱪ
Enoch	Ḩₐnōk
Enos	Enōs
Enos	ʼEnōsh
Enosh	ʼEnōsh
Enrimmon	 ˊĒyn-rimmōn
Epaenetus	Epainetos
Epaphras	Epafras
Epaphroditus	Epafroditos
Ephah	ˊĒyfāh
Epher	ˊĒfer
Ephesian	Efesos
Ephesians	Efesos
Ephesus	Efesos
Ephlal	ʼEflāl
Ephphatha	Effatha
Ephphatha	Fətaḩ
Ephraim	ʼEfrayim
Ephraimite	ʼEfrātī
Ephrain	ˊEfrōn
Ephrath	ʼEfrāt
Ephrathah	ʼEfrātāh
Ephrathite	ʼEfrātī
Ephrathites	ʼEfrātī
Ephrayin	ˊEfrōn
Ephron	ˊEfrōn
Epicureans	Epikoureios
Er	Aʸr
Er	ˊĒr
Erastus	Erastos
Esar	ʼĒşar
Esarhaddon	ʼĒşar-ḩaddōn
Esau	Aʸsau
Esau	ˊĒsāv
Eshbaal	ʼAshbaˊal
Eshban	ʼEshshəbān
Eshcol	ʼEshkol
Eshek	ˊĒsheq
Eshtaol	ʼEshtāʼol
Eshtemoa	ʼEshtəmoˊa
Eshtemoh	ʼEshtəmoˊa
Eshton	ʼEshtōn
Esli	Esli
Esli	ʼElyəhōˊēynay
Esrom	Hesrōm
Esrom	Ḩeʦrōn
Esther	ʼEştēr
Etam	ˊĒyţām
Ethan	ʼĒytān
Ethanim	ʼĒtānīm
Ethbaal	ʼEtbaˊal
Ether	ˊĒter
Ethiopia	Kūsh
Ethiopian	Aithiops
Ethiopian	Kūshiy
Ethiopians	Aithiops
Ethiopians	Kūshiy
Ethnan	ʼEtnan
Eubulus	Euboulos
Eunice	Eunikaʸ
Euodia	Euodia
Euphrates	Eufrataʸs
Euphrates	Pərāt
Euraquilo	Eurokludōn
Eutychus	Eutuⱪos
Eve	Heua
Eve	Ḩavvāh
Ezbai	ʼEzbay
Ezbon	ʼEʦbō
Ezekiel	Yəḩezqēʼl
Ezel	Hāʼēʦel
Ezem	ˊEʦem
Ezer	ʼEʦer
Ezer	ˊEzer
Ezer	ˊĒzer
Ezion	ˊEʦyon
Ezion-	ˊEʦyon
Ezion-gaber	ˊEʦyon-geⱱer
Eziongaber	ˊEʦyon-geⱱer
Eziongeber	ˊEʦyon-geⱱer
Ezra	ˊEzrāʼ
Ezrahite	ʼEzrāḩī
Ezri	ˊEzrī
Felix	Faʸlix
Festus	Faʸstos
Fortunatus	Fortounatos
Gaal	Gaˊal
Gaash	Gaˊash
Gabbai	Gabay
Gabbatha	Gabbatha
Gabriel	Gabriaʸl
Gabriel	Gaⱱrīʼēl
Gad	Gad
Gad	Gād
Gadarenes	Gadaraʸnos
Gaddi	Gaddiy
Gaddiel	Gaddiyʼēl
Gader	Gādēr
Gadi	Gādī
Gadite	Gādī
Gadites	Gādī
Gahar	Gaḩar
Gaius	Gaios
Galal	Gālāl
Galatia	Galatia
Galatian	Galatikos
Galed	Galˊēd
Galilean	Galilaios
Galileans	Galilaios
Galilee	Galilaia
Galilee	Gālīl
Gallia	NOT_Galilaia_NOT
Gallim	Gallim
Gallio	Galliōn
Gamaliel	Gamaliaʸl
Gamaliel	Gamlīʼēl
Gammadim	Gammād
Gammadites	Gammād
Gamul	Gəmūl
Gareb	Gārēⱱ
Garmite	Garmī
Gatam	Gaˊtām
Gath	Gat
Gaza	Gaza
Gaza	ˊAzzāh
Gazez	Gāzēz
Gazzam	Gazzām
Geba	Geⱱaˊ
Gebal	Gəⱱāl
Gebalite	Giⱱlī
Gebalites	Giⱱlī
Geber	Geⱱer
Gebim	Gēⱱīm
Gedaliah	Gədalyāh
Geder	Geder
Gederah	Gədērāh
Gederathite	Gədērātī
Gederite	Gədēry
Gederoth	Gədērōt
Gedi	 Gedī
Gedor	Gədor
Gehazi	Gēyḩₐzī
Gehenna	geenna
Geliloth	Gəlīlōt
Gemalli	Gəmalliy
Gennesaret	Gennaʸsaret
Genubath	Gənūⱱat
Gera	Gērāʼ
Gerar	Gərār
Gerasenes	Gerasaʸnōn
Gerizim	Gərizīm
Gershom	Gērəshom
Gershon	Gērəshōn
Geshan	Gēyshān
Geshem	Geshem
Geshur	Gəshūr
Geshuri	Gəshūrī
Geshurites	Gəshūrī
Gether	Geter
Gethsemane	Gethsaʸmanaʸ
Geuel	Gʼūʼēl
Gezer	Gezer
Giah	Giyaaḩ
Gibbar	Giⱱar
Gibbethon	Gibtōn
Gibea	Giⱱˊāʼ
Gibeah	Giⱱˊāh
Gibeathite	Giⱱˊātī
Gibeon	Giⱱˊōn
Giddalti	Giddaltiy
Giddel	Giddēl
Gideon	Gedeōn
Gideon	Gidˊōn
Gidom	Gidˊom
Gihon	Giyḩōn
Gilalai	Gilₐlay
Gilboa	Gilboˊa
Gilead	Gilˊād
Gilgal	Gilgāl
Giloh	Giloh
Gilonite	Gilonī
Gimzo	Gimzō
Ginath	Ginnat
Ginnetho	Ginnətōn
Ginnethoi	Ginnətōn
Ginnethon	Ginnətōn
Girgashi	Girgāshiy
Girgashite	Girgāshiy
Girgashites	Girgāshiy
Gishpa	Gishpāʼ
Gittaim	Gittayim
Gittite	Gittiy
Gizonite	Gizōnī
Gob	Goⱱ
Gog	Gōg
Golan	Gōlān
Golgotha	Golgotha
Golgotha	Gulgolet
Goliath	Gāləyat
Gomer	Gomer
Gomorrah	Gomorra
Gomorrah	ˊAmorāh
Goshen	Goshen
Goyim	Gōy
Gozan	Gōzān
Greece	Hellas
Greece	Yāvān
Greek	Hellaʸn
Greeks	Hellaʸns
Gudgodah	Gudgo-dāh
Guni	Gūnī
Gur	Gūr
Gur-	Gūr
Gurbaal	Gūr-baˊal
Ha	Ha
Haahashtari	Hāʼₐḩashtārī
Habaiah	Ḩₐⱱayyāh
Habakkuk	Ḩₐⱱaqqūq
Habor	Ḩāⱱōr
Hacaliah	Ḩₐkalyāh
Hachilah	Ḩₐkīlāh
Hachmoni	Ḩakmōnī
Hachmonite	Ḩakmōnī
Hacmoni	Ḩakmōnī
Hacmonite	Ḩakmōnī
Hadad	Hₐdad
Hadadezer	Hₐdadˊezer
Hadassah	Hₐdaşşāh
Hades	Haidaʸs
Hadid	Ḩādīd
Hadlai	Ḩadlay
Hadoram	Hₐdōrām
Hadrach	Ḩadrāk
Hagab	Ḩāgāⱱ
Hagabah	Ḩₐgāⱱāʼ
Hagar	Hagar
Hagar	Hāgār
Hagarites	Hagrī
Hagerite	Hagrī
Hagerites	Hagrī
Haggai	Ḩaggay
Haggeri	Hagrī
Haggiah	Ḩaggiyyāh
Haggith	Ḩaggit
Hagri	Hagrī
Hagrite	Hagrī
Hagrites	Hagrī
Hakkoz	Haqqōʦ
Hakupha	Ḩₐqūfāʼ
Halah	Ḩₐlaḩ
Halak	Ḩālāq
Halhul	Ḩalḩūl
Hali	Ḩₐlī
Hallohesh	Hallōḩēsh
Ham	Ḩām
Hamath	Ḩₐmāt
Hamathite	Ḩₐrodī
Hamathites	Ḩₐrodī
Hamati	Ḩₐrodī
Hammath	Ḩammat
Hammelech	Hamelek
Hammolecheth	Hammoleket
Hammoleketh	Hammoleket
Hammon	Ḩammōn
Hammuel	Ḩammūʼēl
Hamon	Hₐmōn
Hamon-Gog	Hₐmōn-gōg
Hamon-gog	Hₐmōn-gōg
Hamor	Ḩₐmōr
Hamran	Ḩamrān
Hamuel	Ḩammūʼēl
Hamul	Ḩāmūl
Hamutal	Ḩₐmūţal
Hanan	Ḩānān
Hananel	Ḩₐnanʼēl
Hanani	Ḩₐnānī
Hananiah	Ḩₐnanyāh
Haniel	Ḩanniyʼēl
Hannah	Ḩannāh
Hanniel	Ḩanniyʼēl
Hanoch	Ḩₐnōk
Hanun	Ḩānūn
Happizzez	Happiʦʦēʦ
Happuk	Hafūk
Hara	Hārāʼ
Haran	Ḩārān
Haran	Ⱪarran
Hararite	Hₐrārī
Hareph	Ḩārēf
Harhaiah	Ḩarhₐyāh
Harhas	Ḩarḩaş
Harhur	Ḩarḩūr
Harim	Ḩārim
Hariph	Ḩārīf
Harnepher	Ḩarnefer
Harodite	Ḩₐrodī
Haroeh	Hāroʼēh
Harorite	Hₐrōrī
Harsha	Ḩarshāʼ
Harum	Hārum
Harumaph	Ḩₐrūmaf
Haruphite	Ḩₐrūfī
Haruz	Ḩārūʦ
Hasadiah	Ḩₐşadyāh
Hash-	Ḩāsh
Hashabiah	Ḩₐshaⱱyāh
Hashabnah	Ḩₐshaⱱnāh
Hashabneiah	Ḩₐshaⱱnəyāh
Hashbaddanah	Ḩashbaddānāh
Hashem	Hāshēm
Hashubah	Ḩₐshuⱱāh
Hashum	Ḩāshum
Hasrah	Ḩaşrāh
Hassenaah	Haşşənāʼāh
Hassenuah	Şənūʼāh
Hasshub	Ḩashshəūⱱ
Hassophereth	Şoferet
Hasupha	Ḩₐsūfāʼ
Hathath	Ḩtat
Hatipha	Ḩₐţīfāʼ
Hatita	Ḩₐţīţāʼ
Hattil	Ḩaţţil
Hattush	Ḩaţţūsh
Hauran	Ḩavrān
Havilah	Ḩₐvīlāh
Havvoth	Ḩavvōt
Hazael	Ḩₐzāʼēl
Hazaiah	Ḩₐzāyāh
Hazar	 Ḩₐʦar
Hazar-enan	 Ḩₐʦar-ˊēynān
Hazar-enan	 Ḩₐʦar-ˊēynōn
Hazar-hatticon	Ḩₐʦar-hattikōn
Hazar-shual	 Ḩₐʦar-shūˊāl
Hazar-susim	 Ḩₐʦar-şūşīm
Hazarenan	 Ḩₐʦar-ˊēynān
Hazarenan	 Ḩₐʦar-ˊēynōn
Hazarhatticon	Ḩₐʦar-hattikōn
Hazarshual	 Ḩₐʦar-shūˊāl
Hazarsusim	 Ḩₐʦar-şūşīm
Hazazon-	 Ḩaʦʦōn
Hazer	 Ḩₐʦēr
Hazeroth	 Ḩₐʦērōt
Hazezon	 Ḩaʦʦōn
Hazezon-tamar	 Ḩaʦʦōn-tāmār
Hazezontamar	 Ḩaʦʦōn-tāmār
Haziel	Ḩₐzīʼēl
Hazor	Ḩāʦōr
Hazzebaim	Tsəⱱāyīm
Hazzelelponi	Haʦlelpōnī
Heber	Ḩeⱱer
Hebrew	Hebraios
Hebrews	Hebraios
Hebrews	ˊIⱱrī
Hebron	Ḩeⱱrōn
Helah	Ḩelʼāh
Helam	Ḩēylām
Helbah	Ḩelbāh
Helbon	Ḩelbōn
Heldai	Ḩelday
Heleb	Ḩēleⱱ
Heled	Ḩēled
Helem	Helem
Helez	Ḩeleʦ
Heliopolis	Bēyt-shemesh
Helkai	Ḩelqay
Hellenists	Hellaʸnistaʸs
Helon	Ḩēlon
Heman	Hēymān
Hen	Ḩēn
Hena	Hēnaˊ
Henadad	Ḩēnādād
Hepher	Ḩēfer
Heres	Ḩereş
Heresh	Ḩeresh
Hereth	Ḩeret
Hermas	Hermas
Hermes	Hermaʸs
Hermogenes	Hermogenaʸs
Hermon	Ḩermōn
Herod	Haʸrōdaʸs
Herodians	Haʸrōdaʸs
Herodias	Haʸrōidias
Herodion	Haʸrōidiōn
Hesed	Ḩeşed
Heshbon	Ḩeshbōn
Heth	Ḩēt
Hezeki	Ḩizqī
Hezekiah	Hezekias
Hezekiah	Ḩizqiyyāh
Hezion	Ḩezyōn
Hezir	Ḩēzīr
Hezro	Ḩeʦrō
Hezron	Hesrōm
Hezron	Ḩeʦrōn
Hiddai	Hidday
Hiel	Ḩīʼēl
Hierapolis	Hierapolis
Higgaion	Higgāyōn
Hilkiah	Ḩilqiyyāh
Hillel	Hillēl
Hinnom	Hinnom
Hirah	Ḩīrāh
Hiram	Ḩīrām
Hittite	Ḩittiy
Hittites	Ḩittiy
Hivite	Ḩiūī
Hivites	Ḩiūī
Hivvi	Ḩiūī
Hizki	Ḩizqī
Hizkiah	Ḩizqiyyāh
Hobab	Ḩoⱱāⱱ
Hobaiah	Ḩₐⱱayyāh
Hod	Hōd
Hodaviah	Hōdavyāh
Hodesh	Ḩodesh
Hodevah	Hōdəvāh
Hodiah	Hōdiyyāh
Hoham	Hōhām
Holon	Ḩolōn
Homam	Hōmām
Hophni	Ḩāfənī
Horam	Horām
Horeb	Ḩorēⱱ
Horesh	Ḩoresh
Hori	Ḩorī
Horites	Ḩorī
Hormah	Ḩārəmāh
Horon	Ḩōrōn
Hosah	Ḩoşāh
Hosea	Hōshēˊa
Hoshaiah	Hōshiˊīh
Hoshama	Hōshāmāˊ
Hoshea	Hōshēˊa
Hotham	Ḩōtām
Hothir	Hōtīr
Hozai	Ḩōzay
Hozeh	Ḩozeh
Hukkok	Ḩuqqoq
Hukok	Ḩuqqoq
Hul	Ḩūl
Huldah	Ḩuldāh
Huppah	Ḩuppāh
Huppim	Ḩuppim
Hur	Ḩūr
Hurai	Ḩūray
Huram	Ḩūrām
Huri	Ḩūrī
Hushah	Ḩūshāh
Hushai	Ḩūshay
Husham	Ḩūshām
Hushathite	Ḩushātī
Hushim	Ḩushim
Hymeneus	Humenaios
Ibhar	Yāⱱəḩar
Ibleam	Yiⱱləˊām
Ibneiah	Yiⱱnəyāh
Ibnijah	Yiⱱniyyāh
Ibri	ˊIⱱrī
Ibsam	Yiⱱsām
Ibzan	ʼIⱱʦān
Ichabod	ʼĪ-kāⱱōd
Iconium	Ikonion
Idbash	Yidbās
Iddo	Yiddō
Iddo	ˊIddō
Idumea	Idoumaia
Igal	Yigʼāl
Ijon	ˊIyyōn
Ikkesh	ˊIqqēsh
Ilai	ˊĪlay
Illyricum	Illurikon
Imlah	Yimlāʼ
Immanu-el	ˊImmānū-ʼēl
Immanuel	ˊImmānū-ʼēl
Immer	ʼImmēr
Imna	Yimnāˊ
Imnah	Yimnāh
Imnites	Yimnāh
Imra	Yimrāh
Imri	ʼImrī
India	Hodū
Iphdeiah	Yifdəyāh
Iphedeiah	Yifdəyāh
Ir	ˊĪr
Ir-nahash	ˊĪr-nāḩāsh
Ira	ˊĪrāʼ
Iram	ˊĪrām
Iri	ˊĪrī
Irnahash	ˊĪr-nāḩāsh
Isaac	Isaʼak
Isaac	Yiʦḩāq
Isaiah	Aʸsaias
Isaiah	Yəshaˊyāh
Iscariot	Iskariōtaʸs
Ish-bosheth	ʼĪsh-bshet
Ishbah	Yishbaḩ
Ishbak	Yishbāq
Ishbosheth	ʼĪsh-bshet
Ishhod	ʼĪshəhōd
Ishi	Yishˊī
Ishma	Yishmāʼ
Ishmael	Yishmāˊēʼl
Ishmaelite	Yishmāˊēʼlī
Ishmaelites	Yishmāˊēʼlī
Ishmaiah	Yishmaˊyāh
Ishmeelites	Yishmāˊēʼlī
Ishmerai	Yishməray
Ishpah	Yishpāh
Ishpan	Yishpān
Ishuah	Yishvāh
Ishuai	Yishvāh
Ishvah	Yishvāh
Ishvi	Yishvī
Ismachiah	Yişmakyāhū
Israel	Israaʸl
Israel	Yisrāʼēl
Israelites	Israaʸl
Israelites	Yisrāʼēl
Issachar	Isaⱪar
Issachar	Yissāskār
Isshiah	Yishshiyyāh
Italian	Italia
Italy	Italia
Ithai	ʼIttay
Ithamar	ʼĪtāmār
Ithiel	ʼĪtīʼēl
Ithmah	Yitmāh
Ithran	Yitrān
Ithream	Yitrəˊām
Ithrite	Yitrī
Ittai	ʼIttay
Iturea	Itouraios
Ivvah	ˊIvvāh
Izeharites	Yiʦhārī
Izhar	Yiʦhār
Izhar	Yiʦḩar
Izharites	Yiʦhārī
Izliah	Yizlīʼāh
Izrahiah	Yizraḩyāh
Izrahite	Yizrāḩ
Izri	Yiʦrī
Izziah	Yizziyyāh
Jaakan	Yaˊₐqān
Jaakobah	Yaˊₐqoⱱāh
Jaala	Yaˊₐlāʼ
Jaalah	Yaˊₐlāʼh
Jaanai	Yaˊₐnay
Jaar	Yaˊar
Jaareshiah	Yaˊₐreshyāh
Jaasiel	Yaˊₐsiyʼēl
Jaasu	Yaˊₐsū
Jaazaniah	Yaʼₐzanyāh
Jaaziah	Yaˊₐziyyāhū
Jaaziel	Yaˊₐzīʼēl
Jabbok	Yaboq
Jabesh	Yāⱱēsh
Jabez	Yaˊbēʦ
Jabin	Yāⱱīn
Jabneh	Yaⱱneh
Jacan	Yaˊkān
Jachin	Yākīn
Jacob	Yakōb
Jacob	Yaˊₐqoⱱ
Jacobus	Yakōbos
Jacobus	Yaˊₐqoⱱ
Jada	Yādāˊ
Jadau	Yiddō
Jaddai	Yiddō
Jaddua	Yaddūˊa
Jadon	Yādōn
Jael	Yāˊēl
Jahath	Yaḩat
Jahaz	Yahaʦ
Jahaziah	Yaḩzəyāh
Jahaziel	Yaḩₐzīʼēl
Jahdai	Yehday
Jahdiel	Yaḩdiyʼēl
Jahdo	Yaḩdō
Jahmai	Yaḩmay
Jahzah	Yahaʦ
Jahzeiah	Yaḩzəyāh
Jahzerah	Yaḩzērāh
Jahziel	Yaḩʦīʼēl
Jair	Yāʼīr
Jairus	Yaeiros
Jakan	Yaˊₐqān
Jakeh	Yāqeh
Jakim	Yāqīm
Jakin	Yākīn
Jalam	Yaˊlām
Jalon	Yālōn
Jambres	Yambraʸs
James	Yakōbos
James	Yaˊₐqoⱱ
Jamin	Yāmīn
Jaminite	Yəmīnī
Jamlech	Yamlēk
Janai	Yaˊₐnay
Jannai	Yanna
Jannai	Yānāh
Jannes	Yannaʸs
Janoah	Yānōaḩ
Janohah	Yānōaḩ
Japheth	Yefet
Japhia	Yāfīˊa
Japhlet	Yaflēţ
Jarah	Yaˊrāh
Jared	Yared
Jared	Yered
Jaresiah	Yaˊₐreshyāh
Jarha	Yarḩāˊ
Jarib	Yārīⱱ
Jarmuth	Yarmūt
Jaroah	Yārōaḩ
Jashen	Yāshēn
Jashobeam	Yāshāⱱəˊām
Jashub	Yāshūⱱ
Jashubi-lehem	Yāshuⱱī-leḩem
Jashubilehem	Yāshuⱱī-leḩem
Jason	Yasōn
Jathniel	Yatnīʼēl
Jattir	Yattir
Javan	Yāvān
Jazer	Yaˊzēr
Jaziz	Yāzīz
Jearim	Yəˊārīm
Jeatherai	Yəʼₑtəray
Jeberechiah	Yəⱱerekyāhū
Jeberekiah	Yəⱱerekyāhū
Jebus	Yəⱱūş
Jebusite	Yəⱱūşī
Jebusites	Yəⱱūşī
Jecamiah	Yəqamyāh
Jechiliah	Yəkāləyāh
Jecholiah	Yəkāləyāh
Jechoniah	Yəkānəyāh
Jechonias	Yeⱪonias
Jechonias	Yəkānəyāh
Jecoliah	Yəkāləyāh
Jeconiah	Yəkānəyāh
Jedaiah	Yədaˊyāh
Jediael	Yədīˊₐʼēl
Jedidah	Yədīdāh
Jedidiah	Yədīdəyāh
Jedithun	Yədūtūn
Jeduthun	Yədūtūn
Jehalelel	Yəhallelʼēl
Jehallelel	Yəhallelʼēl
Jehdeiah	Yeḩdiyyāhū
Jehezkel	Yəḩezqēʼl
Jehiah	Yəḩiyyāh
Jehiel	Yəˊīʼēl
Jehiel	Yəḩīʼēl
Jehizkiah	Yəḩizqiyyāh
Jehoadah	Yəhōˊaddāh
Jehoaddah	Yəhōˊaddāh
Jehoaddan	Yəhōˊaddin
Jehoaddin	Yəhōˊaddin
Jehoahaz	Yəhōʼāḩāz
Jehoash	Yəhōʼāsh
Jehohanan	Yəhōḩānān
Jehoiachin	Yōyākīn
Jehoiachin	Yəhōyākīn
Jehoiada	Yōyādāˊ
Jehoiada	Yəhōyādāˊ
Jehoiakim	Yəhōyāqīm
Jehoiarib	Yəhōyārīⱱ
Jehonathan	Yəhōnātān
Jehoram	Yəhōrām
Jehoshabeath	Yəhōshaⱱˊat
Jehoshaphat	Yōshāfāţ
Jehoshaphat	Yəhōshāfāţ
Jehosheba	Yəhōsheⱱaˊ
Jehozabad	Yəhōzāⱱād
Jehozadak	Yəhōʦādāq
Jehu	Yēhūʼ
Jeiel	Yəˊīʼēl
Jekabzeel	Yəqaⱱʦəʼēl
Jekameam	Yəqamˊām
Jekamiah	Yəqamyāh
Jekuthiel	Yəqūtīʼēl
Jemimah	Yəmīmāh
Jephtha	Yefthae
Jephtha	Yiftāḩ
Jephthah	Yiftāḩ
Jephunneh	Yəfunneh
Jerah	Yeraḩ
Jerahmeel	Yəraḩməʼēl
Jerahmeelites	Yəraḩməʼēlī
Jeremai	Yərēmay
Jeremiah	Yeremias
Jeremiah	Yirməyāh
Jeremoth	Yərīmōt
Jeriah	Yəriyyāh
Jeribai	Yərīⱱay
Jericho	Yeriⱪō
Jericho	Yərīḩō
Jeriel	Yərīʼēl
Jerimoth	Yərīmōt
Jerioth	Yərīˊōt
Jermoth	Yərīmōt
Jeroboam	Yārāⱱəˊām
Jeroham	Yəroḩām
Jerubbaal	Yərubaˊal
Jerubbesheth	Yərubeshet
Jeruel	Yərūʼēl
Jerusalem	Hierousalaʸm
Jerusalem	Yərūshelēm
Jerusalem	Yərūshālam
Jerusalem	Yərūshālayim
Jerusalemites	Hierousalaʸm
Jerusalemites	Yərūshālam
Jerusha	Yərūshāʼ
Jerushah	Yərūshāʼh
Jesaiah	Yəshaˊyāh
Jeshaiah	Yəshaˊyāh
Jeshanah	Yəshānāh
Jesharelah	Yəsarʼēlāh
Jesher	Yēsher
Jeshimon	Yəshimōn
Jeshimoth	Hyəshimōt
Jeshishai	Yəshiyshāy
Jeshohaiah	Yəshōḩāyāh
Jeshua	Yēshūˊa
Jeshurun	Yəshurūn
Jesimiel	Yəshimāʼēl
Jesimoth	Hyəshimōt
Jesse	Yessai
Jesse	Yishay
Jesus	Yaʸsous
Jesus	Yəhōshūˊa
Jether	Yeter
Jetheth	Yətēt
Jethro	Yitrō
Jetur	Yəţūr
Jeuel	Yəˊūʼēl
Jeush	Yəˊūsh
Jeuz	Yəˊūʦ
Jew	Youdaios
Jewish	Youdaiōns
Jewish	Yəhūdī
Jews	Youdaiōns
Jews	Yəhūdī
Jezebel	ʼĪzeⱱel
Jezer	Yēʦer
Jeziah	Yizziyyāh
Jeziel	Yəzavʼēl
Jezliah	Yizlīʼāh
Jezrahiah	Yizraḩyāh
Jezreel	Yizrəˊēʼl
Jezreelite	Yizrəˊēʼlī
Jibsam	Yiⱱsām
Jimna	Yimnāh
Jimnah	Yimnāh
Jimnites	Yimnāh
Jitschar	Yiʦḩar
Jitsri	Yiʦrī
Joab	Yōʼāⱱ
Joah	Yōʼāḩ
Joanan	Yōanan
Joanna	Yōanna
Joash	Yōʼāsh
Joatham	Yōatham
Joatham	Yōtām
Job	Iōb
Job	ʼIyyōⱱ
Jobab	Yōⱱāⱱ
Jochebed	Yōkeⱱed
Jodah	Youda
Jodah	Yuţţāh
Joed	Yōˊēd
Joel	Yōaʸl
Joel	Yōʼēl
Joelah	Yōˊēʼlāh
Joezer	Yōˊezer
Jogbehah	Yāgəbəhāh
Joha	Yōḩāʼ
Johanan	Yōḩānān
John	Yōannaʸs
Joiada	Yōyādāˊ
Joiakim	Yōyāqīm
Joiarib	Yōyārīⱱ
Jokdeam	Yāqədəˊām
Jokim	Yōqīm
Jokmeam	Yāqəməˊām
Jokneam	Yāqənəˊām
Jokshan	Yāqəshān
Joktan	Yāqəţān
Joktheel	Yāqətəʼēl
Jonadab	Yōnādāⱱ
Jonah	Yōnas
Jonah	Yōnāh
Jonam	Yōnan
Jonathan	Yōnātān
Jonathan	Yəhōnātān
Joppa	Yoppaʸ
Joppa	Yāfō
Jorah	Yōrāh
Jorai	Yōray
Joram	Yōram
Joram	Yōrām
Joram	Yəhōrām
Jordan	Yardēn
Jordan	Yordanaʸs
Jorim	Yōreim
Jorim	Yōrām
Jorkeam	Yārəqəˊām
Josabad	Yōzāⱱād
Josaphat	Yōsafat
Josaphat	Yəhōshāfāţ
Joseph	Yōsaʸf
Joseph	Yōşēf
Joses	Yōsaʸs
Joses	Yōşēf
Joshah	Yōshāh
Joshaphat	Yōshāfāţ
Joshaviah	Yōshavyāh
Joshbekashah	Yāshəbəqāshāh
Joshibiah	Yōshiⱱyāh
Joshua	Yaʸsous
Joshua	Yəhōshūˊa
Josiah	Yōsias
Josiah	Yʼoshiyyāh
Josibiah	Yōshiⱱyāh
Josiphiah	Yōşifyāh
Jotbah	Yāţəⱱāh
Jotbathah	Yāţəⱱātāh
Jotham	Yōatham
Jotham	Yōtām
Jozabad	Yōzāⱱād
Jozadak	Yōʦādāq
Judah	Youda
Judah	Yəhūdāh
Judaism	Youdaismos
Judas	Youdas
Judas	Yəhūdāh
Jude	Youdas
Jude	Yəhūdāh
Judea	Youdaia
Judean	Yəhūdī
Judeans	Youdaia
Judeans	Yəhūdī
Julia	Youlia
Julius	Youlios
Junia	Younias
Jushab	Yūshaⱱ
Jushab-hesed	Yūshaⱱ-ḩeşed
Jushabhesed	Yūshaⱱ-ḩeşed
Justus	Youstos
Kabzeel	Qaⱱʦəʼēl
Kadesh	Qādēsh
Kadmiel	Qadmīʼēl
Kallai	Qallay
Kalneh	Kələneh
Kamon	Qāmōn
Kanaan	Kinaˊan
Kanneh	Kanneh
Kareah	Qārēaḩ
Karka	Qarqaˊ
Karkor	Qarqor
Karnaim	Qarnāyim
Kasdim	Kasdiy
Kebar	Kəⱱār
Kedar	Qēdār
Kedemah	Qədəmāh
Kedemoth	Qədēmōt
Kedesh	Qedesh
Kedron	Kedrōn
Kedron	Qidrōn
Keilah	Qəˊīlāh
Kelaiah	Qēlāyāh
Kelita	Qəlīţāʼ
Kelub	Kəlūⱱ
Keluhi	Kəlūhayo
Kemuel	Qəmūʼēl
Kenaan	Kinaˊan
Kenaanah	Kənaˊₐnāh
Kenaani	Kənaˊₐnī
Kenan	Qēynān
Kenani	Kənānī
Kenaniah	Kənanyāh
Kenath	Qənāt
Kenaz	Qənaz
Kenite	Qēynī
Kenites	Qēynī
Kephirah	Kəfīrāh
Keran	Kərān
Keren	Qeren
Keren-Happuk	Qeren-hafūk
Kerethites	Kərētī
Kerioth	Qəriyyōt
Keros	Qēyroş
Kerub	Kərūⱱ
Kesalon	Kəşālōn
Keturah	Qəţūrāh
Keziah	Qəʦīˊāh
Kibroth-	Qiⱱrōt-
Kibroth-hattaavah	Qiⱱrōt-hattaʼₐvāh
Kibrothhattaavah	Qiⱱrōt-hattaʼₐvāh
Kidon	Kīdōn
Kidron	Qidrōn
Kilmad	Kilmād
Kinnereth	Kinₐrōt
Kir	Qīr
Kiriath	Qiryat
Kiriathaim	Qērəyātayim
Kirjathaim	Qērəyātayim
Kis	Kis
Kis	Qīsh
Kish	Qīsh
Kishion	Qishyōn
Kishon	Qīshōn
Kislev	Kişlēv
Kitron	Qiţrōn
Kittim	Kittim
Kiyyun	Kīyyūn
Koa	Qōˊa
Kohath	Qəhāt
Kohathite	Qₑhātī
Kohathites	Qₑhātī
Kolaiah	Qōlāyāh
Konaniah	Kōnanyāhū
Korah	Qoraḩ
Korah	Qārəḩī
Korahite	Qārəḩī
Korahites	Qārəḩī
Kore	Kore
Kore	Qoraḩ
Kore	Qōrēʼ
Kores	Qārəḩī
Korhite	Qārəḩī
Korhites	Qārəḩī
Kos	Qōʦ
Kozeba	Kozāⱱāʼ
Kush	Kūsh
Kushaiah	Qūshāyāhū
Laadah	Laˊdāh
Laban	Lāⱱān
Lachish	Lākīsh
Ladan	Laˊdān
Lael	Lāʼēl
Lahad	Lahad
Lahmi	Laḩmī
Laish	Layish
Laishah	Layish
Lamech	Lameⱪ
Lamech	Lemek
Lamek	Lemek
Laodicea	Laodikeia
Laodiceans	Laodikeia
Lappidoth	Lappidōt
Lasaea	Lasaia
Lazarus	Lazaros
Leah	Lēʼāh
Lebanah	Ləⱱānāʼ
Lebanon	Ləⱱānōn
Lebbaios	Lebbaios
Lebo	Ləⱱōʼ
Lebonah	Ləⱱōnāh
Lecah	Lēkāh
Lehab	Lehāⱱīm
Lehabim	Lehāⱱīm
Lehabites	Lehāⱱīm
Lehem	Leḩem
Lehi	Leḩī
Lemuel	Ləmūʼēl
Levi	Leui
Levi	Lēvī
Levite	Leuitaʸs
Levite	Lēviyyiy
Levite	from_tribe_of_Lēvī
Levites	Lēviyyiy
Libnah	Liⱱnāh
Libni	Liⱱnī
Libya	Kūⱱ
Libya	Libuaʸ
Libyans	Lūⱱī
Likhi	Liqḩī
Linus	Linos
Lo-ruhamah	Loʼ-ruḩāmāh
Lod	Lod
Lois	Lōis
Loruhamah	Loʼ-ruḩāmāh
Lot	Lōt
Lot	Lōţ
Lotan	Lōţān
Lubim	Lūⱱī
Lucius	Loukios
Lud	Lūd
Ludim	Lūdī
Ludites	Lūdī
Luke	Loukas
Luz	Lūz
Lycaonia	Lukaonia
Lycia	Lukia
Lyconian	Lukaonisti
Lydda	Lod
Lydda	Ludda
Lydia	Ludia
Lydians	Lūdī
Lysanias	Lusanios
Lysias	Lusias
Lystra	Lustra
Maacah	Maˊₐkāh
Maacath	Maˊₐkāh
Maacathite	Maˊₐkātī
Maacathites	Maˊₐkātī
Maadai	Maˊₐday
Maadiah	Maˊₐdəyāh
Maai	Māˊay
Maarath	Maˊₐrāt
Maasai	Maˊₐsay
Maaseiah	Maˊₐsēyāh
Maasiai	Maˊₐsay
Maat	Maʼath
Maat	Māˊaţ
Maath	Maʼath
Maath	Māˊaţ
Maaz	Maˊaʦ
Maaziah	Maˊazyāh
Macedonia	Makedonia
Macedonian	Makedonia
Macedonians	Makedonia
Machbanai	Makbannay
Machbena	Makbēnāʼ
Machi	Mākī
Machir	Mākīr
Machnadebai	Maknadⱱay
Madai	Māday
Maday	Māday
Madmannah	Madmannāh
Madmenah	Madmēnāh
Madon	Mādōn
Magadan	Magadan
Magbish	Magbiysh
Magdalene	Magdala
Magdiel	Magdiyʼēl
Magog	Magōg
Magog	Māgōg
Magpiash	Magpiyˊāsh
Mahalalel	Mahₐlalʼēl
Mahalath	Maḩₐlat
Mahanaim	Maḩₐnāyim
Maharai	Mahₐray
Mahath	Maḩat
Mahavite	Maḩₐvīm
Mahazioth	Maḩₐzīʼōt
Maher-	Mahēr-
Maher-shalal-hash-baz	Mahēr-shālāl-ḩāsh-baz
Mahershalalhashbaz	Mahēr-shālāl-ḩāsh-baz
Mahlah	Maḩlāh
Mahli	Maḩlī
Mahlon	Maḩlōn
Maim	Mayim
Makaz	Māqaʦ
Makir	Mākīr
Makkedah	Maqqēdāh
Malachi	Malʼākī
Malcam	Malkām
Malchi	Malkī
Malchi-shua	Malkīshūˊa
Malchiah	Malkīyyāh
Malchiel	Malkīʼēl
Malchijah	Malkīyyāh
Malchiram	Malkīrām
Malchishua	Malkīshūˊa
Malchus	Malⱪos
Maleleel	Mahₐlalʼēl
Maleleel	Maleleaʸl
Malki	Malkī
Malkiah	Malkīyyāh
Malkijah	Malkīyyāh
Mallothi	Mallōtī
Malluch	Mallūk
Manaen	Manaaʸn
Manahath	Mānaḩat
Manasseh	Manassaʸs
Manasseh	Mənashsheh
Manoah	Mānōaḩ
Maoch	Māˊōk
Maon	Māˊōn
Maralah	Marʼₐlāh
Mareshah	Marʼēshāh
Mark	Markos
Maroth	Mārōt
Martha	Martha
Mary	Maria
Mary	Miryām
Mashal	Māshāl
Masrekah	Masrēqāh
Massa	Massāʼ
Massah	Maşşāh
Mathusala	Mathousala
Mathusala	Mətūshelaḩ
Matred	Maţrēd
Matrite	Maţrī
Mattan	Mattān
Mattaniah	Mattanyāh
Mattat	Maththat
Mattatah	Mattattāh
Mattatha	Mattatha
Mattatha	Mattattāh
Mattathah	Mattattāh
Mattathias	Mattathias
Mattathias	Mattityāh
Mattenai	Mattənay
Matthan	Matthan
Matthan	Mattān
Matthat	Maththat
Matthat	Matthat
Matthat	Mattāt
Matthew	Matthaios
Matthias	Matthias
Mattithiah	Mattityāh
Me-	Mēy-
Mebunnai	Məⱱunnay
Mecherathite	Məkērātī
Meconah	Məkonāh
Medan	Mədān
Mede	Māday
Medeba	Mēydəⱱāʼ
Medes	Maʸdia
Medes	Māday
Media	Māday
Megiddo	Məgiddōn
Mehetabel	Məhēyţaⱱʼēl
Mehida	Məḩīdāʼ
Mehir	Məḩīr
Meholathite	Məḩolātī
Mekonah	Məkonāh
Melatiah	Məlaţyāh
Melchi	Melek
Melchi	Melⱪi
Melchiah	Malkīyyāh
Melchisedek	Malkī-ʦedeq
Melchisedek	Melⱪisedek
Melchishua	Malkīshūˊa
Melchizedek	Malkī-ʦedeq
Melea	Meleas
Melea	Məlēʼāh
Melech	Melek
Melita	Melitaʸ
Melkiah	Malkīyyāh
Memphis	Mof
Memphis	Nof
Menahem	Mənaḩēm
Menna	Mainan
Meon	Məˊōn
Meonothai	Məˊōnotay
Mephaath	Mōfaˊat
Mephibosheth	Mufīboshet
Merab	Mērāⱱ
Meraiah	Mərāyāh
Meraioth	Mərāyōt
Merari	Mərārī
Mered	Mered
Meremoth	Mərēmōt
Merib	Mərīⱱ
Merib-baal	Mərīⱱ-baˊal
Meribah	Mərīⱱāh
Meribath	Mərīⱱāh
Meribbaal	Mərīⱱ-baˊal
Merodach	Mərodak
Merom	Mērōm
Meronothite	Mēronotī
Meroz	Mērōz
Mesech	Meshek
Mesha	Mēyshaˊ
Mesha	Mēyshāʼ
Meshach	Mēyshak
Meshech	Meshek
Meshek	Meshek
Meshelemiah	Məshelemyāh
Meshezabel	Məshēyzaⱱʼēl
Meshillemith	Məshillēmīt
Meshillemoth	Məshillēmōt
Meshobab	Məshōⱱāⱱ
Meshullam	Məshullām
Meshullemeth	Məshullemet
Mesopotamia	Mesopotamia
Methuselah	Mətūshelaḩ
Meunim	Məˊūnāy
Meunites	Məˊūnāy
Mezahab	Mēy-zāhāⱱ
Mezobaite	Məʦoⱱāyāh
Miamin	Miyyāmin
Mibhar	Miⱱḩār
Mibsam	Miⱱsām
Mibzar	Miⱱʦār
Mica	Mīkəʼ
Micah	Mīkāh
Micah	Mīkāyāh
Micaiah	Mīkāhū
Micaiah	Mīkāyāh
Micaiah	Mīkāyəhū
Michael	Miⱪaaʸl
Michael	Mīkāʼēl
Michal	Mīkāl
Michmash	Mikmāş
Michmethath	Mikmətāt
Micmash	Mikmāş
Midian	Madiam
Midian	Midyān
Migdol	Migdōl
Migron	Migrōn
Mijamin	Miyyāmin
Mikloth	Miqlōt
Mikneiah	Miqnēyāhū
Milalai	Milₐlay
Milcom	Malkām
Miletus	Milaʸtos
Millo	Millōʼ
Miniamin	Minyāmīn
Minnit	Minnit
Minnith	Minnit
Miriam	Miryām
Mirma	Mirmāh
Mirmah	Mirmāh
Mishael	Mīshāʼēl
Misham	Mishˊām
Mishma	Mishmāˊ
Mishraites	Mishrāˊī
Mispar	Mişfār
Mispereth	Mişferet
Mithnite	Mitnī
Mithredath	Mitrədāt
Mitylene	Mitulaʸnaʸ
Mizah	Miʦˊār
Mizpah	Miʦpāh
Mizraim	Miʦrayim
Mizzah	Mizzāh
Mnason	Mnasōn
Moab	Mōʼāⱱ
Moadiah	Mōˊadyāh
Moladah	Mōlādāh
Molech	Molek
Molid	Mōlīd
Moloch	Molek
Moloch	Moloⱪ
Morasthite	Mōrashtiy
Mordecai	Mārəddəkay
Moreh	Mōreh
Moresheth	Mōrashtiy
Moriah	Mōriyyāh
Moserah	Mōşērāh
Moseroth	Mōşērāh
Moses	Mosheh
Moses	Mōsaʸs
Moza	Mōʦāʼ
Mushi	Mūshiy
Myra	Mura
Mysia	Musia
Naam	Naˊam
Naamah	Naˊₐmāh
Naaman	Naˊₐmān
Naaman	Neʼeman
Naarah	Naˊₐrāh
Naarai	Naˊₐray
Naaran	Naˊₐrān
Naasson	Naʼassōn
Naasson	Naḩshōn
Nabal	Nāⱱāl
Naboth	Nāⱱōt
Nachon	Nākōn
Nachor	Naⱪōr
Nachor	Nāḩōr
Nacon	Nākōn
Nadab	Nādāⱱ
Naggai	Nangai
Naggai	Nogah
Nahalal	Nahₐlāl
Nahalol	Nahₐlāl
Naham	Naḩam
Nahamani	Naḩₐmānī
Naharai	Naḩₐray
Naharaim	Nahₐrayim
Nahash	Nāḩāsh
Nahath	Naḩat
Nahbi	Naḩbiy
Nahor	Nāḩōr
Nahshon	Naḩshōn
Nahum	Naoum
Nahum	Naḩūm
Nain	Nain
Naioth	Nāvīt
Naomi	Nāˊₒmī
Naphish	Nāfīsh
Naphtali	Naftālī
Naphtuh	Naftuḩīm
Naphtuhim	Naftuḩīm
Naphtuhites	Naftuḩīm
Narcissus	Narkissos
Natham	Nathan
Natham	Nātān
Nathan	Nathan
Nathan	Nātān
Nathanael	Nathanaaʸl
Naum	Naoum
Naum	Naḩūm
Nazarean	Nazaraʸnos
Nazarene	Nazaret
Nazarenes	Nazōraios
Nazareth	Nazaret
Nazirite	Nāzīr
Nazirites	Nāzīr
Neariah	Nəˊaryāh
Nebai	Nōⱱay
Nebaioth	Nəⱱāyōt
Neballat	Nəⱱallāţ
Nebat	Neⱱaţ
Nebo	Nəⱱō
Nebuchadnezzar	Nəⱱūkadneʦʦar
Nebuzaradan	Nəⱱūzarʼₐdān
Necho	Nəkoh
Necho	Nəkō
Nechoh	Nəkoh
Neco	Nəkoh
Neco	Nəkō
Nedabiah	Nədaⱱyāh
Negev	Negeⱱ
Nego	Nəgō
Nehemiah	Nəḩemyāh
Nehum	Nəḩūm
Nehushta	Nəḩushtāʼ
Nekoda	Nəqōdāʼ
Nemuel	Nəmūʼēl
Nepheg	Nefeg
Nephisim	Nəfīşīm
Nephthalim	Naftālī
Nephthalim	Nefthaleim
Nephusim	Nəfūshəşīm
Ner	Nēr
Nereus	Naʸreus
Nergal	Nērəggal
Neri	Naʸri
Neri	Nēriyyāh
Neriah	Nēriyyāh
Netaim	Nəţāˊīm
Nethanel	Nətanʼēl
Nethaniah	Nətanyāh
Netophah	Nəţofāh
Netophathite	Nəţofātī
Netophathites	Nəţofātī
Neziah	Nəʦīaḩ
Nibhaz	Niⱱḩaz
Nicanor	Nikanōr
Nicodemus	Nikodaʸmos
Nicolaitans	Nikolaitaʸs
Nicolas	Nikolaos
Nicopolis	Nikopolis
Niger	Niger
Nimrod	Nimrōd
Nimshi	Nimshiy
Nineveh	Nīnəvēh
Ninevite	Nineuitaʸs
Ninevite	from_Nīnəvēh
Ninevites	Nineuitaʸs
Ninevites	\add >ones\add*_from_Nīnəvēh
Nisroch	Nəşirok
No	Noʼ
Noadiah	Nōˊadyāh
Noah	Noaḩ
Noah	Noˊāh
Noah	Nōe
Nob	Nōd
Nobah	Noⱱaḩ
Nod	Nōd
Nodab	Nōdāⱱ
Nogah	Nogah
Nohah	Nōḩāh
Noph	Nof
Nun	Nūn
Nympha	Numfas
Obadiah	ˊOⱱadyāh
Obed	Yōbaʸd
Obed	ˊŌⱱēd
Obed	Ὠβήδ
Obed-edom	ˊOⱱēd-ʼₑdōm
Obededom	ˊOⱱēd-ʼₑdōm
Obil	ʼŌⱱīl
Ochran	ˊĀkərān
Ocran	ˊĀkərān
Oded	ˊŌdēd
Og	ˊŌg
Ohel	ʼOhel
Oholah	ʼĀhₑlāh
Oholiab	ʼĀhₑlīʼāⱱ
Oholibah	ʼĀhₑlīⱱāh
Oholibamah	ʼĀhₑlīⱱāmāh
Olympas	Olumpas
Omar	ʼŌmār
Omri	ˊĀmərī
Onam	ʼŌnām
Onan	ʼŌnān
Onesimus	Onaʸsimos
Onesiphorus	Onaʸsiforos
Ono	ʼŌnō
Ophel	ˊOfel
Ophir	ʼŌfīr
Ophrah	ˊĀfərāh
Oreb	ˊOrēⱱ
Oren	ʼOren
Ornan	ʼĀrənān
Osnappar	ʼĀşənappar
Othni	ˊĀtənī
Othniel	ˊĀtənīʼēl
Ozem	ʼOʦem
Ozias	Ozias
Ozias	ˊUzziyyāh
Paarai	Paˊₐray
Paddan	Paddan
Padon	Fādōn
Pagiel	Pagˊīʼēl
Pahath	Paḩat
Pahath-moab	Paḩat-mōʼāⱱ
Pahathmoab	Paḩat-mōʼāⱱ
Pai	Fāˊū
Palal	Pālāl
Palestina	Fəleshet
Pallu	Pallūʼ
Palti	Falţī
Paltiel	Falţīʼēl
Paltite	Palţī
Pamphylia	Pamfulia
Paphos	Pafos
Paran	Pāʼrān
Parmenas	Parmenas
Parosh	Farˊosh
Parthians	Parthia
Paruah	Pārūaḩ
Parvaim	Farvayim
Pas-	Faş-
Pasach	Pāşak
Pasdammim	Faş-dammim
Paseah	Pāşēaḩ
Pashhur	Fashḩūr
Pashur	Fashḩūr
Patara	Patara
Pathros	Patrōş
Pathrus	Patruşī
Pathrusim	Patruşī
Pathrusites	Patruşī
Patmos	Patmos
Patrobas	Patrobas
Pau	Fāˊū
Paul	Paulos
Pedah-	Pədāh-
Pedahzur	Pədāhʦūr
Pedaiah	Pədāyāh
Pekah	Fəqaḩyāh
Pekahiah	Pəqaḩyāh
Pekod	Fəqōd
Pelaiah	Pəlāyāh
Pelaliah	Pəlalyāh
Pelatiah	Pəlaţyāh
Peleg	Falek
Peleg	Feleg
Peleg	Peleg
Pelet	Peleţ
Peleth	Pelet
Pelethites	Fəlētī
Pelonite	Pəlōnī
Peniel	Pənīʼēl
Peninnah	Fəninnāh
Penuel	Pənūʼēl
Peor	Pəˊōr
Perazim	Pərāʦīm
Peresh	Peresh
Perez	Fares
Perez	Fereʦ
Perez	Pereʦ
Perga	Pergaʸ
Pergamus	Pergamos
Perida	Fərūdāʼ
Perizzite	Pərizzī
Perizzites	Pərizzī
Persia	Pāraş
Persis	Persis
Peruda	Fərūdāʼ
Peter	Petros
Pethahiah	Pətaḩyāh
Pethor	Fətōr
Pethuel	Pətūʼēl
Peullethai	Pəˊullətay
Peulthai	Pəˊullətay
Phallu	Pallūʼ
Phanuel	Fanouaʸl
Pharaoh	Faraō
Pharaoh	Farˊoh
Pharaoh	Parˊoh
Pharisee	Farisaios
Pharisees	Farisaios
Pharpar	Farfar
Phicol	Fīkol
Philadelphia	Filadelfeia
Philemon	Filaʸmoni
Philetus	Filaʸtos
Philip	Filippos
Philippi	Filippou
Philippians	Filippaʸsios
Philistia	Fəleshet
Philistines	Fəlishtiy
Philologus	Filologos
Phinehas	Pinḩāş
Phlegon	Flegōn
Phoebe	Foibaʸ
Phoenicia	Foinikaʸ
Phoenix	Foinix
Phrygia	Frugia
Phygelus	Fugelos
Pi-	Piy-
Pi-beseth	Piy-ⱱeşet
Pilate	Pilatos
Pilha	Pilḩāʼ
Piltai	Filţay
Pinon	Fīnon
Pirathon	Firˊātōn
Pirathonite	Pirˊātōnī
Pisgah	Pişgāh
Pisidia	Pisidia
Pispa	Fişāfāh
Pithon	Pitōn
Pizzez	Piʦʦēʦ
Pochereth	Fokeret
Pokereth	Fokeret
Pontius	Pontios
Pontus	Pontos
Porcius	Porkios
Potiphar	Fōţīfar
Potiphera	Fōţī-feraˊ
Prisca	Priska
Priscilla	Priskilla
Prochorus	Proⱪoros
Ptolemais	Ptolemais
Puah	Pūˊāh
Publius	Poplios
Pudens	Poudaʸs
Pul	Pūl
Purah	Furāh
Put	Pūţ
Puteoli	Potioloi
Puthites	Pūtī
Putiel	Fūţīʼēl
Qiryataim	Qērəyātayim
Quartus	Kouartos
Raama	Raˊmāh
Raamah	Raˊmāh
Raamiah	Raˊamyāh
Rabbah	Rabāh
Racal	Rākāl
Rachal	Rākāl
Rachel	Rāḩēl
Rachel	Ɽaⱪaʸl
Raddai	Radday
Ragau	Rəˊū
Ragau	Ɽagau
Rahab	Rāḩāⱱ
Rahab	Ɽaⱪab
Raham	Raḩam
Ram	Rām
Rama	Rāmāh
Rama	Ɽama
Ramah	Rāmāh
Ramathaim	Rāmātayim
Ramathite	Rāmātī
Ramiah	Rməyāh
Ramoth	Rāmot
Ramoth	Rāʼmōt
Rapha	Rāfāʼ
Raphaites	Rəfāʼīm
Raphu	Rāfūʼ
Reaiah	Rəʼāyāh
Rebecca	Riⱱqāh
Rebecca	Ɽebekka
Rebekah	Riⱱqāh
Recah	Rēkāh
Rechab	Rēkāⱱ
Rechabites	Rēkāⱱīm
Reelaiah	Rəˊēlāyāh
Regem	Regem
Regem-	Regem
Regemmelech	Regem-melek
Rehabiah	Rəḩaⱱyāh
Rehob	Rəḩoⱱ
Rehoboam	Rəḩaⱱˊām
Rehoboam	Ɽoboam
Rehoboth	Rəḩoⱱōt
Rehum	Rəḩūm
Rei	Rēˊī
Rekah	Rēkāh
Rekem	Reqem
Remaliah	Rəmalyāhū
Rephael	Rəfāʼēl
Rephah	Refaḩ
Rephaiah	Rəfāyāh
Rephaim	Rəfāʼīm
Rephaites	Rəfāʼīm
Rephidim	Rəfīdīm
Resheph	Reshef
Reu	Rəˊū
Reuben	Rəʼūⱱēn
Reuben	Ɽoubim
Reuel	Rəˊūʼēl
Rezeph	Reʦef
Rezia	Riʦyāʼ
Rezin	Rəʦīn
Rezon	Rəzōn
Rhegium	Ɽaʸgion
Rhesa	Rəfāyāh
Rhesa	Ɽaʸsa
Rhoda	Ɽodaʸ
Rhodes	Ɽodos
Ribai	Rīⱱay
Riblah	Riⱱlāh
Rimmon	 Rimmōn
Rimmon	Rimmōn
Rinnah	Rinnāh
Riphath	Rīfat
Rizia	Riʦyāʼ
Rizpah	Riʦfāh
Rodanim	Dodānīm
Rogelim	Roglīm
Rohgah	Rōhₐgāh
Romamti	Rōmamtiy
Romamti-ezer	Rōmamtiy-ˊezer
Romamtiezer	Rōmamtiy-ˊezer
Roman	Ɽōmaios
Romans	Ɽōmaios
Rome	Ɽōmaʸ
Romfa	Ɽemfan
Rufus	Ɽoufos
Ruhamah	Ruḩāmāh
Rumah	Rūmāh
Ruth	Rūt
Ruth	Ɽouth
Sabeans	Şāⱱāʼ
Sabta	Şaⱱtāʼ
Sabteka	Şaⱱtəkāʼ
Sacar	Sākār
Sachar	Sākār
Sadducee	Saddoukaios
Sadducees	Saddoukaios
Sakar	Sākār
Sala	Sala
Sala	Shelaḩ
Salah	Shelaḩ
Salamis	Salamis
Salathiel	Salathiaʸl
Salathiel	Shəʼaltiyʼēl
Salecah	Şalkāh
Salem	Salaʸm
Salem	Shālēm
Salim	Saleim
Sallai	Şallū
Sallu	Şallū
Salma	Salmāʼ
Salmon	Salmōn
Salome	Salōmaʸ
Salu	Şallū
Samaria	Samareia
Samaria	Shomrōn
Samaritan	Samareia
Samaritan	Shomrōn
Samaritans	Samareitaʸs
Samaritans	Shomrōn
Samlah	Samlāh
Samos	Samos
Samothrace	Samothrakaʸ
Samson	Sampsōn
Samson	Shimshōn
Samuel	Samouaʸl
Samuel	Shəmūʼēl
Sanballat	Şanⱱallaţ
Saph	Şaf
Sapphira	Sapfeiraʸ
Sarah	Sarra
Sarah	Seraḩ
Sarah	Sārāh
Saraph	Sārāf
Sardis	Sardeis
Sarepta	Sarepta
Sarepta	Tsₑrəfat
Sarid	Sārīd
Saron	Assarōn
Saron	Shārōn
Satan	Satan
Satan	Sāţān
Saul	Saulos
Saul	Shāʼūl
Sceva	Skeuas
Scythian	Skuthaʸs
Seba	Şəⱱāʼ
Secu	Sēkū
Secundus	Sekoundos
Segub	Səgūⱱ
Seir	Sēˊīr
Sela	Şelaˊ
Selah	Şelāh
Seled	Şeled
Seleucia	Seleukeia
Sem	Saʸm
Sem	Shēm
Semachiah	Şəmakyāhū
Semein	Semei
Semein	Shimˊī
Senaah	Şənāʼāh
Seneh	Şenneh
Senir	Sənīr
Sennacherib	Şanḩērīⱱ
Senuah	Şənūʼāh
Seorim	Səˊorīm
Sepharad	Şəfārād
Sepharvaim	Şəfarvayim
Sepharvites	Şəfarvī
Serah	Seraḩ
Seraiah	Sərāyāh
Sergius	Sergios
Seruch	Serouⱪ
Seruch	Sərūg
Serug	Sərūg
Seth	Saʸth
Seth	Shēt
Sethur	Şətūr
Shaalbim	Shaˊalⱱīm
Shaalbonite	Shaˊalⱱonī
Shaalim	Shaˊₐlīm
Shaaph	Shaˊaf
Shaaraim	Shaˊₐrayim
Shabbethai	Shabtay
Shachia	Shāⱱəyāh
Shadrach	Shadrak
Shagee	Shāgēh
Shalal-	Shālāl-
Shalishah	Shālishāh
Shallecheth	Shalleket
Shalleketh	Shalleket
Shallum	Shallūm
Shallun	Shallūn
Shalmai	Salmay
Shalmai	Shamlay
Shalmaneser	Shalmanʼeşer
Shama	Shāmāˊ
Shamed	Shemer
Shamer	Shemer
Shamgar	Shamgar
Shamhuth	Shamhūt
Shamir	Shāmīr
Shamir	Shāmūr
Shamma	Shammāʼ
Shammah	Shammāh
Shammai	Shammay
Shammay	Shammay
Shammoth	Shammōt
Shammua	Shammūˊa
Shamsherai	Shamshəray
Shapham	Shāfām
Shaphan	Shāfān
Shaphat	Shāfāţ
Shaphir	Shāfīr
Sharai	Shāray
Sharar	Shārar
Sharezer	Sharʼeʦer
Sharon	Shārōn
Sharuhen	Shārūḩēn
Shashai	Shāshay
Shashak	Shāshshaq
Shaul	Shāʼūl
Shavsha	Shavshāʼ
Sheal	Shəʼāl
Shealtiel	Shəʼaltiyʼēl
Shean	Shəʼān
Shear-	Shəʼār-
Shear-jashub	Shəʼār-yāshūⱱ
Sheariah	Shəˊaryāh
Shearjashub	Shəʼār-yāshūⱱ
Sheba	Sheⱱaˊ
Sheba	Shəⱱāʼ
Shebaniah	Shəⱱanyāh
Shebarim	Shəⱱārīm
Sheber	Sheⱱer
Shebna	Sheⱱnāʼ
Shebnah	Sheⱱnāʼ
Shebuel	Shəⱱūʼēl
Shecaniah	Shəkanyāh
Shechem	Shəkem
Shechem	Suⱪem
Shedeur	Shədēyʼūr
Sheerah	Sheʼₑrāh
Shehariah	Shəḩaryāh
Shelah	Shelaḩ
Shelah	Shilluḩāh
Shelah	Shēlāh
Shelemiah	Shelemyāh
Sheleph	Shelef
Shelesh	Shelesh
Shelomith	Shəlomīt
Shelomoth	Shəlomōt
Shelumiel	Shəlumīʼēl
Shem	Shēm
Shema	Shemaˊ
Shemaah	Shəmāˊāh
Shemaiah	Shəmaˊyāh
Shemariah	Shəmaryāh
Shemer	Shemer
Shemesh	Shemesh
Shemida	Shəmīdāˊ
Sheminith	Shəmīnīt
Shemiramoth	Shəmīrāmōt
Shemuel	Shəmūʼēl
Shen	Shēn
Shenazzar	Shenʼaʦʦar
Sheol	Shəʼōl
Shephatiah	Shəfaţyāh
Shephi	Shəfō
Shepho	Shəfō
Shephupham	Shəfūfām
Sherebiah	Shērēⱱəyāh
Sheresh	Sheresh
Sheshai	Shēshay
Sheshan	Shēshān
Sheshbazzar	Shēshəbaʦʦar
Shethar	Shətar
Shethar-bozenai	Shətar-bōzənay
Shetharboznai	Shətar-bōzənay
Sheva	Shəvāʼ
Shiggaion	Shiggāyōn
Shigionoth	Shiggāyōn
Shihor	Shiyḩōr
Shikkeron	Shikkərōn
Shilhi	Shilḩī
Shiloah	Shilluḩāh
Shiloh	Shiloh
Shilonite	Shilōnī
Shilshah	Shilshāh
Shimea	Shimˊāʼ
Shimeah	Shimˊāh
Shimeath	Shimˊat
Shimeathites	Shimˊātī
Shimei	Shimˊī
Shimon	Shimōn
Shimrath	Shimrāt
Shimri	Shimrī
Shimrith	Shimryt
Shimron	Shimrōn
Shimshai	Shimshay
Shinar	Shinˊār
Shiphi	Shifˊī
Shiphmite	Shifmī
Shiphrah	Shifrāh
Shipi	Shifˊī
Shirtai	Shiţray
Shisha	Shiyshāʼ
Shishak	Shiyshaq
Shitrai	Shiţray
Shittim	Shiţţīm
Shiza	Shizāʼ
Shoa	Shōˊa
Shobab	Shōⱱāⱱ
Shobach	Shōⱱāk
Shobai	Shⱱay
Shobal	Shōⱱāl
Shobek	Shōⱱēq
Shobi	Shⱱī
Shoham	Shoham
Shomer	Shōmēr
Shophach	Shōfāk
Shua	Shūˊa
Shua	Shūˊāʼ
Shuah	Shūˊa
Shuah	Shūḩāh
Shual	Shūˊāl
Shubael	Shəūⱱʼēl
Shuhah	Shūḩāh
Shulamite	Shūlammit
Shulammite	Shūlammit
Shumathites	Shumātī
Shunammite	Shūnammit
Shunem	Shūnēm
Shuppim	Shuppim
Shur	Shūr
Shushan	Shūshan
Shuthelah	Shūtelaḩ
Sia	Şīˊāʼ
Siaha	Şīˊāʼ
Sibbecai	Şiⱱkay
Sibraim	Şiⱱrayim
Sidon	Sidōn
Sidon	Tsīdōn
Sidonians	Tsīdonī
Sihon	Şīḩōn
Sihor	Shiyḩōr
Sikkuth	Şikkūt
Silas	Silas
Silla	Şillāʼ
Siloah	Shilluḩāh
Siloam	Silōam
Silvanus	Silouanos
Simeon	Shimˊōn
Simeon	Sumeōn
Simon	Simōn
Sin	Şīn
Sinai	Sina
Sinai	Şīnay
Sini	Şīnī
Sinite	Şīnī
Sinites	Şīnī
Sion	Siyʼon
Siphmoth	Sifmōt
Sippai	Şifay
Sirion	Shiryōn
Sisera	Şīşərāʼ
Sismay	Şişmay
Siyon	Siyʼon
Smyrna	Smurna
So	Şōʼ
Socoh	Sōkoh
Sodi	Şōdī
Sodom	Sodoma
Sodom	Şədom
Solomon	Shəlmoh
Solomon	Shəlomoh
Solomon	Solomōn
Sopater	Sōpatros
Sophereth	Şoferet
Sorek	Sōrēq
Sosipater	Sōsipatros
Sosthenes	Sōsthenaʸs
Sotai	Şōţay
Spain	Spania
Stachys	Staⱪus
Stephanas	Stefanas
Stephen	Stefanos
Stoic	Stōikos
Suah	Şūaḩ
Sucathites	Sūkātī
Succoth	Şukkōt
Sukkiim	Şukkī
Sukkiims	Şukkī
Suph	Şūf
Susa	Shūshan
Susi	Şūşī
Sychar	Suⱪar
Syene	Şəvēnēh
Syntyche	Suntuⱪaʸ
Syracuse	Surakousai
Syria	Suria
Syria	ʼArām
Syrian	Suria
Syrian	ʼArammiy
Syrians	ʼArammiy
Syrians	ʼArām
Syrophoenician	Foinikaʸ_in_Suria
Syrtis	Surtis
Taanach	Taˊₐnāk
Tabbaoth	Ţabāˊōt
Tabbath	Ţabat
Tabeal	Ţₑⱱəʼēl
Tabeel	Ţₑⱱəʼēl
Taberah	Taⱱˊērāh
Tabitha	Tabaʸtha
Tabor	Tāⱱōr
Tabrimmon	Ţaⱱrimmōn
Tadmor	Tadmor
Tahan	Taḩan
Tahath	Taḩat
Tahchemonite	Taḩkəmonī
Tahpanhes	Taḩfanḩēş
Tahpenes	Taḩpənēyş
Tahrea	Taḩrēˊa
Talimay	Talimay
Talmai	Talimay
Talmon	Ţalmōn
Tamar	Tāmār
Tammuz	Tammūz
Tanhumeth	Tanḩumet
Taphath	Ţāfat
Tappuah	Tapūaḩ
Tarea	Taʼₐrēˊa
Tarshish	Tarshiysh
Tarshiysh	Tarshiysh
Tarsian	Tarsos
Tarsus	Tarsos
Tartak	Tartāq
Tatnai	Tattənay
Tattenai	Tattənay
Tebaliah	Ţəⱱalyāhū
Tehaphnehes	Taḩfanḩēş
Tehinnah	Təḩinnāh
Tekoa	Təqōˊa
Tekoa	Təqōˊī
Tekoite	Təqōˊī
Tekoites	Təqōˊī
Tel	Tēl
Telah	Telaḩ
Telaim	Ţəlāʼīm
Telassar	Təlaʼssar
Telem	Ţelem
Tema	Tēymāʼ
Temah	Temaḩ
Teman	Tēymān
Temanite	Tēymānī
Temanites	Tēymānī
Temeni	Tēymənī
Terah	Teraḩ
Tertius	Tertios
Tertullus	Tertullos
Thaddeus	Thaddaios
Thamar	Thamar
Thamar	Tāmār
Thara	Teraḩ
Thara	Thara
Thebes	Noʼ
Thebez	Tēⱱēʦ
Theophilus	Theofilos
Thessalonian	Thessalonikaʸ
Thessalonians	Thessalonikaʸ
Thessalonica	Thessalonikaʸ
Theudas	Theudas
Thomas	Thōmas
Thyatira	Thuateira
Tiberias	Tiberios
Tibhath	Ţⱱəḩat
Tibni	Tiⱱnī
Tidal	Tidˊāl
Tiglath	Tiglat
Tiglath-	Tiglat
Tiglath-pileser	Tiglat-pilʼeşer
Tiglathpileser	Tiglat-pilʼeşer
Tikvah	Tiqvāh
Tilgath	Tiglat
Tilgath-pileser	Tiglat-pilʼeşer
Tilgathpileser	Tiglat-pilʼeşer
Tilon	Tūlōn
Timeus	Timaios
Timna	Timnāˊ
Timnah	Timnāh
Timon	Timōn
Timothy	Timotheos
Tiphsah	Tifşaḩ
Tiras	Tirāş
Tirathites	Tirˊātī
Tirhakah	Tirhāqāh
Tirhanah	Tirḩₐnāh
Tiria	Tiryāʼ
Tirzah	Tirʦāh
Tishbite	Tishbiy
Titus	Titos
Tizite	Tiyʦī
Toah	Tōaḩ
Tob	Ţōⱱ
Tobadonijah	Ţōⱱ-ʼₐdoniyyāhū
Tobiah	Ţōⱱiyyāh
Tobijah	Ţōⱱiyyāh
Tochen	Token
Togarmah	Tōgarmāh
Tohu	Toḩū
Toi	Toˊū
Token	Token
Tokhath	Tōqahat
Tola	Tōlāˊ
Tophel	Tofel
Topheth	Tofet
Tou	Toˊū
Trachonitis	Traⱪōnitis
Troas	Trōias
Trophimus	Trofimos
Tryphena	Trufaina
Tryphosa	Trufōsa
Tsemari	Tsəmārī
Tubal	Tūⱱal
Tychicus	Tuⱪikos
Tyrannus	Turannos
Tyre	Tsor
Tyre	Turos
Tyrians	Tsor
Tyrians	Tsorī
Tyrians	Turos
Ucal	ʼUkāl
Uel	ʼŪʼēl
Ulai	ʼŪlay
Ulam	ʼŪlām
Ulla	ˊUllāʼ
Unni	ˊUnniy
Uphaz	ʼŪfāz
Ur	ʼŪr
Urbanus	Ourbanos
Uri	ʼŪrī
Uriah	Ourias
Uriah	ʼŪriyyāh
Uriel	ʼŪrīʼēl
Uthai	ˊŪtay
Uz	ˊŪʦ
Uzai	ʼŪzay
Uzal	ʼŪzāl
Uzzah	ˊUzzāʼ
Uzzen	ʼUzzēn
Uzzen-sheerah	ʼUzzēn-sheʼₑrāh
Uzzensheerah	ʼUzzēn-sheʼₑrāh
Uzzi	ˊUzziy
Uzzia	ˊUzziyyāʼ
Uzziah	Ozias
Uzziah	ˊUzziyyāh
Uzziel	ˊUzziyʼēl
Vaniah	Vanyāh
Vashni	Vashinī
Vedan	Vədān
Vophsi	Vāfəşī
Yavan	Yāvān
Yazer	Yaˊₐzēyir
Yebusi	Yəⱱūşī
Yihudah	Yəhūdāh
Yishay	Yishay
Yishmāˊēʼl	Yishmāˊʼēl
Yizrəˊēʼl	Yizrəˊʼēl
Yəḩezqēʼl	Yəḩezqʼēl
Zaanan	Tsaʼₐnān
Zaanannim	Tsaˊₐnannim
Zaavan	Zaˊₐvān
Zabad	Zāⱱād
Zabbai	Zabay
Zabbud	Zabūd
Zabdi	Zaⱱdiy
Zabdiel	Zaⱱdiyʼēl
Zabud	Zāⱱūd
Zabulon	Zaboulōn
Zabulon	Zəⱱūlūn
Zaccai	Zakkay
Zaccheus	Zakⱪaios
Zaccur	Zakkūr
Zacharias	Zaⱪarias
Zacher	Zeker
Zadok	Sadōk
Zadok	Tsādōq
Zahab	Zāhāⱱ
Zaham	Zāham
Zahar	Tsaḩar
Zalaph	Tsālāf
Zalmon	Tsalmōn
Zalmun	Tsalmōn
Zalmunna	Tsalmunnāˊ
Zamzummin	Zamzom
Zamzummites	Zamzom
Zanoah	Zānōaḩ
Zara	Zara
Zara	Zeraḩ
Zarephath	Tsₑrəfat
Zarethan	Tsₑrətān
Zarhites	Zarḩī
Zattu	Zattūʼ
Zavan	Zaˊₐvān
Zaza	Zāzāʼ
Zealot	Farisaios_zaʸlōtaʸs
Zebadiah	Zəⱱadyāh
Zebah	Zeⱱaḩ
Zebaim	Tsəⱱāyīm
Zebedee	Zebedaios
Zebidah	Zəⱱīdāh
Zebina	Zəⱱīnāʼ
Zeboiim	Tsəⱱoʼīm
Zeboim	Tsəⱱoˊīm
Zebul	Zəⱱul
Zebulun	Zəⱱūlūn
Zechariah	Zaⱪarias
Zechariah	Zəkaryāh
Zecher	Zeker
Zedad	Tsədād
Zedek	Tsedeqḩ
Zedekiah	Tsidqiyyāh
Zeeb	Zəʼēⱱ
Zelek	Tseleq
Zelophehad	Tsəlāfəḩād
Zelzah	Tselʦaḩ
Zemaraim	Tsəmārayim
Zemarite	Tsəmārī
Zemarites	Tsəmārī
Zemirah	Zəmīrāh
Zenas	Zaʸnas
Zephaniah	Tsəfanyāh
Zephath	Tsəfat
Zephathah	Tsəfātāh
Zephi	Tsəfō
Zepho	Tsəfō
Zerah	Zeraḩ
Zerahiah	Zəraḩyāh
Zerahites	Zarḩī
Zered	Zered
Zeredah	Tsərēdāh
Zererah	Tsərērāh
Zereth	Tseret
Zeri	Tsərī
Zeror	Tsərōr
Zeruah	Tsərūˊāh
Zerubbabel	Zərubāⱱel
Zeruiah	Tsərūyāh
Zetham	Zētām
Zethan	Zēytān
Zeus	Zeus
Zia	Zīˊa
Ziba	Tsīⱱāʼ
Zibeon	Tsiⱱˊōn
Zibia	Tsiⱱyāʼ
Zibiah	Tsiⱱyāh
Zichri	Zikrī
Ziha	Tsīḩāʼ
Ziklag	Tsiqlag
Zikri	Zikrī
Zillah	Tsillāh
Zillethai	Tsillətay
Zilthai	Tsillətay
Zimmah	Zimmāh
Zimran	Zimrān
Zimri	Zimrī
Zin	Tsin
Zina	Zīnāʼ
Zion	Siōn
Zion	Tsiyyōn
Ziph	Zīf
Ziphah	Zīfāh
Ziphims	Zīfī
Ziphites	Zīfī
Zippor	Tsipōr
Zipporah	Tsiporāh
Ziv	Ziv
Ziz	Tsīʦ
Ziza	Zīzāʼ
Zizah	Zīzāh
Zoan	Tsoˊan
Zoar	Tsoˊar
Zobah	Tsōⱱāh
Zobebah	Tsoⱱēⱱāh
Zoheth	Zōḩēt
Zophah	Tsōfaḩ
Zophai	Tsūf
Zophim	Tsōfīm
Zorah	Tsārəˊāh
Zorathites	Tsārəˊī
Zorites	Tsārəˊī
Zorobabel	Zorobabel
Zorobabel	Zərubāⱱel
Zuar	Tsūˊār
Zuph	Tsūf
Zur	Tsūr
Zuri-	Tsūrī-
Zuriel	Tsūrīʼēl
Zurishaddai	Tsūrī-shadday
adonijah	ʼₐdoniyyāhū
arabah	ˊₐrāⱱāh
arba	ʼarbaˊ
asherah	ʼₐshērāh
baal	baˊal
barnea	barnēˊa
baz	baz
beno	bənō
beseth	ⱱeşet
biri	birʼī
bosheth	bshet
bozenai	bōzənay
boznai	bōzənay
dammim	dammim
edom	ʼₑdōm
eglaim	 ˊeglayim
el	ʼēl
enan	 ˊēynān
enan	 ˊēynōn
ephah	ʼēyfāh
ephrathah	ʼefrātāh
ezer	ˊezer
gaber	geⱱer
gader	gādēr
geber	geⱱer
gedi	 gedī
gilead	gilˊād
gittith	gittit
gog	gōg
hadad	hₐdad
haddon	ḩaddōn
hail	ḩayil
hash	ḩāsh
hattaavah	hattaʼₐvāh
hatticon	hattikōn
hattikon	hattikōn
hazzebaim	ʦəⱱāyīm
hozeh	ḩozeh
jaakan	yaˊₐqan
jashub	yāshūⱱ
jearim	yəˊārīm
jeshimoth	hyəshimōt
jesimoth	hyəshimōt
lehem	leḩem
marcaboth	hmmrəkkāⱱōt
melah	melaḩ
meon	məˊōn
merodach	mərodak
omer	ˊomer
peor	pəˊōr
perazim	pərāʦīm
pileser	pilʼeşer
rabbim	rabim
rimmon	 rimmōn
shaddai	shadday
shalal-	shālāl-
shean	shəʼān
sheba	sheⱱaˊ
sheerah	sheʼₑrāh
shemesh	shemesh
sheminith	shəmīnīt
sheol	shəʼōl
shephelah	shəfēlāh
shua	shūˊa
shual	 shūˊāl
susim	 şūşīm
tamar	 tāmār
zahab	zāhāⱱ
zoheth	zōḩēt
zophim	ʦōfīm
zur	ʦūr
